'em	ah m #1
-knacks	n ae k s
-upmanship	ah p m ah n sh ih p
-ups	ah p s #1
-zagged	z ae g d
a	ah #1
abbreviate	ah b r iy v iy ey t
abdomen	ae b d ah m ah n
abides	ah b ay d z
ability	ah b ih l ih t iy
able	ey b l #1
ably	ey b l iy
abolish	ah b aa l ih sh
aborigine	ae b er ih jh ih n iy #1
aborigines	ae b er ih jh ih n iy z
about	ah b aw t
above	ah b ah v
abruptly	ah b r ah p t l iy
absences	ae b s ih n s ih z
absent	ae b s ih n t
absolute	ae b s ah l uw t
absolution	ae b s ah l uw sh ih n
absorbed	ah b s aa r b d
absorption	ah b s aa r p sh ih n
absurd	ah b s er d #1
absurdly	ah b s er d l iy
abyss	ah b ih s
academic	ae k ih d eh m ih k
accelerating	ae k s eh l er ey t ih ng
accelerometer	ae k s eh l er aa m ah t er #1
accelerometers	ae k s eh l er aa m ah t er z
accent	ae k s eh n t
accept	ae k s eh p t #1
acceptance	ae k s eh p t ih n s
accepted	ae k s eh p t ih d
access	ae k s eh s
accident	ae k s ih d ih n t
acclaim	ah k l ey m #1
acclaimed	ah k l ey m d
accommodate	ah k aa m ah d ey t
accomplish	ah k aa m p l ih sh #1
accomplished	ah k aa m p l ih sh t
accomplishments	ah k aa m p l ih sh m ah n t s
according	ah k aa r d ih ng #1
accordingly	ah k aa r d ih ng l iy
account	ah k aw n t #1
accounts	ah k aw n t s
accreditation	ah k r eh d ih t ey sh ih n
accuracy	ae k y er ah s iy
accurate	ae k y er ih t
accusations	ae k y uw z ey sh ih n z
accuse	ah k y uw z #1
accusingly	ah k y uw z ih ng l iy
ace	ey s
aches	ey k s
achieve	ah ch iy v #1
achieved	ah ch iy v d
acknowledge	ae k n aa l ih jh #1
acknowledged	ae k n aa l ih jh d
acquiescence	ae k w iy eh s ih n t s
acquire	ah k w ay er
acres	ey k er z
acropolis	ah k r aa p l ah s
across	ah k r aa s
act	ae k t #1
action	ae k sh ih n #1
actions	ae k sh ih n z
activated	ae k t ih v ey t ih d
activities	ae k t ih v ah t iy z
activity	ae k t ih v ah t iy #1
actor	ae k t er #1
actors	ae k t er z
acts	ae k t s
actual	ae k ch uw l #1
actually	ae k ch uw l iy
adage	ae d ih jh
adaptations	ae d ae p t ey sh ih n z
add	ae d #1
added	ae d ih d
addition	ah d ih sh ih n
additives	ae d ih t ih v z
address	ae d r eh s
addressed	ah d r eh s t
adequate	ae d ih k w ih t
adhesive	ae d hh iy s ih v
adjourned	ah jh er n d
adjustable	ah jh ah s t ah b l
adjustments	ah jh ah s t m ah n t s
administration	ah d m ih n ih s t r ey sh ih n
administrative	ah d m ih n ih s t r ey t ih v
admire	ah d m ay er
admitted	ah d m ih t ih d
admitting	ah d m ih t ih ng
adopted	ah d aa p t ih d
adult	ah d ah l t #1
adulterers	ah d ah l t er er z
adulthood	ah d ah l t hh uh d
adults	ah d ah l t s
advance	ae d v ae n s #1
advanced	ae d v ae n s t
advances	ae d v ae n s ih z
advantage	ae d v ae n t ih jh #1
advantages	ae d v ae n t ih jh ih z
adventure	ah d v eh n ch er #1
adventures	ah d v eh n ch er z
advertising	ae d v er t ay z ih ng
advice	ah d v ay s
advisable	ah d v ay z ah b l
advised	ah d v ay z d
advisement	ah d v ay z m ah n t
aerial	ae r iy l
affect	ah f eh k t
affectionate	ah f eh k sh ih n ih t
affirmative	ah f er m ah t ih v
afloat	ah f l ow t
afraid	ah f r ey d
after	ae f t er #1
afternoon	ae f t er n uw n
afterwards	ae f t er w er d z
again	ah g eh n #1
against	ah g eh n s t
age	ey jh #1
agency	ey jh ih n s iy
agenda	ah jh eh n d ah
agents	ey jh ih n t s
agglomeration	ah g l aa m er ey sh ih n
aggressive	ah g r eh s ih v
aglow	ah g l ow
ago	ah g ow
agony	ae g ih n iy
agree	ah g r iy #1
agreed	ah g r iy d
agricultural	ae g r ih k ah l ch er l
ahah	aa hh aa
ahead	ah hh eh d
aid	ey d #1
aided	ey d ih d
aids	ey d z
aim	ey m #1
aimed	ey m d
aimless	ey m l ah s
ain't	ey n t
air	ae r #1
airborne	ae r b aa r n
aircraft	ae r k r ae f t
airfields	ae r f iy l d z
airplanes	ae r p l ey n z
al	ae l #1
alarm	ah l aa r m
alcohol	ae l k ah hh aa l #1
alcoholic	ae l k ah hh aa l ih k #1
alcoholics	ae l k ah hh aa l ih k s
alcoves	ae l k ow v z
alert	ah l er t
alfalfa	ae l f ae l f ah
algae	ae l jh iy
algebraic	ae l jh ih b r ey ih k
alibi	ae l ih b ay
alice	ae l ih s #1
alice's	ae l ih s ih z
alien	ey l iy ah n
aligned	ah l ay n d
aligning	ah l ay n ih ng
alimony	ae l ah m ow n iy
alkaline	ae l k ah l ay n
all	aa l #1
all-purpose	aa l p er p ah s
allergies	ae l er jh iy z
alleviate	ah l iy v iy ey t
alligators	ae l ah g ey t er z
allot	ah l aa t
allow	ah l aw #1
allowable	ah l aw ah b l
allowance	ah l aw ah n s
allowed	ah l aw d #1
allure	ah l uh r
almonds	aa m ah n d z
almost	aa l m ow s t
alone	ah l ow n
along	ah l aa ng
aloud	ah l aw d #2
already	aa l r eh d iy
also	aa l s ow
alternated	aa l t er n ey t ih d
alternative	aa l t er n ih t ih v
although	aa l dh ow
altogether	aa l t ih g eh dh er
aluminum	ah l uw m ih n ah m
alumni	ah l ah m n ay
always	aa l w ey z
am	ae m #1
amateur	ae m ah ch er
amaze	ah m ey z #1
amazed	ah m ey z d
ambassador	ae m b ae s ah d er #1
ambassador's	ae m b ae s ah d er z
amber	ae m b er
ambidextrous	ae m b ih d eh k s t r ih s
ambiguity	ae m b ah g y uw ih t iy
ambiguous	ae m b ih g y uw ah s
ambitions	ae m b ih sh ih n z
ambitious	ae m b ih sh ih s
ambled	ae m b l d
ambulance	ae m b y uh l ah n s
american	ah m eh r ih k ih n
ammo	ae m ow
amoebas	ah m iy b ah z
among	ah m ah ng
amorist	ae m aa r ih s t
amount	ah m aw n t #1
amounts	ah m aw n t s
ample	ae m p l
an	ae n #1
anaesthesia	ae n ih s th iy sh ah
analysis	ah n ae l ih s ih s
analyticity	ae n ah l ih t ih s ih t iy
anarchy	ae n er k iy
anatomical	ae n ih t aa m ih k l
anchor	ae ng k er
ancient	ey n sh ih n t
and	ae n d #1
andrei's	ae n d r ey z
anecdotal	ae n eh k d ow t l
anger	ae ng g er
angora	ae ng g aa r ah
angrily	ae ng g r ah l iy
angry	ae ng g r iy
angular	ae ng g y uh l er
animal	ae n ih m l #1
animals	ae n ih m l z
ankle	ae ng k l
announcing	ah n aw n s ih ng
annoying	ah n oy ih ng
annual	ae n y uw l
anonymous	ah n aa n ah m ah s
another	ah n ah dh er
answer	ae n s er #1
answered	ae n s er d
answers	ae n s er z
ant	ae n t #1
antagonistic	ae n t ae g ah n ih s t ih k
antarctic	ae n t aa r k t ih k
antelope	ae n t ah l ow p
anti-	ae n t ay #1
anti-infective	ae n t ay ih n f eh k t ih v
anti-slavery	ae n t ay s l ey v er iy
anticipated	ae n t ih s ah p ey t ih d
antigen	ae n t ih jh ih n
antiseptic	ae n t ih s eh p t ih k
antithesis	ae n t ih th ih s ih s
ants	ae n t s
anxiety	ae ng z ay ih t iy
any	eh n iy #1
anybody	eh n iy b aa d iy
anyhow	eh n iy hh aw
anyone	eh n iy w ah n #1
anyone's	eh n iy w ah n z
anything	eh n iy th ih ng
anyway	eh n iy w ey
apartments	ah p aa r t m ah n t s
apology	ah p aa l ah jh iy
apparently	ah p ae r ah n t l iy
appealing	ah p iy l ih ng
appear	ah p ih r #1
appearance	ah p ih r ah n s
appeared	ah p ih r d
appears	ah p ih r z
appetite	ae p ah t ay t #1
appetites	ae p ah t ay t s
appetizers	ae p ah t ay z er z
apple	ae p l #1
apples	ae p l z
appliances	ah p l ay ih n s ih z
applicability	ae p l ih k ah b ih l ih t iy
application	ae p l ih k ey sh ih n #1
applications	ae p l ih k ey sh ih n z
applied	ah p l ay d
applies	ah p l ay z
apply	ah p l ay #1
applying	ah p l ay ih ng
appointed	ah p oy n t ih d
appointment	ah p oy n t m ah n t
appraisal	ah p r ey z l
appreciate	ah p r iy sh iy ey t #1
appreciated	ah p r iy sh iy ey t ih d
appreciatively	ah p r iy sh ih t ih v l iy
approach	ah p r ow ch #1
approached	ah p r ow ch t
appropriate	ah p r ow p r iy ah t
approval	ah p r uw v l
approved	ah p r uw v d
approvingly	ah p r uw v ih ng l iy
approximated	ah p r aa k s ih m ey t ih d
approximation	ah p r aa k s ih m ey sh ih n
aprons	ey p r ah n z
aptitude	ae p t ih t uw d
aquatic	ah k w aa t ih k
arbitrary	aa r b ah t r eh r iy
arbitrate	aa r b ah t r ey t
arboreal	aa r b aa r iy l
arc	aa r k #1
arcade	aa r k ey d
archeological	aa r k iy ah l aa jh ih k l
are	aa r #1
area	ae r iy ah #1
areas	ae r iy ah z
aren't	aa r n t
argue	aa r g y uw #1
argued	aa r g y uw d
argument	aa r g y uw m ah n t
arise	ah r ay z #1
arises	ah r ay z ih z
aristocratic	ah r ih s t ih k r ae t ih k
arm	aa r m #1
armchair	aa r m ch ae r
armed	aa r m d
arms	aa r m z
army	aa r m iy
arose	ah r ow z
around	ah r aw n d
arrange	ah r ey n jh #1
arranged	ah r ey n jh d
arrival	ah r ay v l
arrive	ah r ay v #1
arrived	ah r ay v d
arriving	ah r ay v ih ng
art	aa r t #1
article	aa r t ih k l
articulation	aa r t ih k y uh l ey sh ih n
artificial	aa r t ih f ih sh l
artist	aa r t ih s t #1
artistic	aa r t ih s t ih k
artists	aa r t ih s t s
as	ae z #1
ashamed	ah sh ey m d
ashtray	ae sh t r ey
aside	ah s ay d
ask	ae s k #1
asked	ae s k t
asleep	ah s l iy p
aspect	ae s p eh k t #1
aspects	ae s p eh k t s
assail	ah s ey l
assassin	ah s ae s ih n
assaults	ah s aa l t s
assembled	ah s eh m b l d
assembling	ah s eh m b l ih ng
assert	ah s er t
assign	ah s ay n #1
assignment	ah s ay n m ah n t
assistance	ah s ih s t n s
assistant	ah s ih s t ih n t
associated	ah s ow s iy ey t ih d
associates	ah s ow s iy ey t s
associations	ah s ow s iy ey sh ih n z
assume	ah s uw m #1
assumed	ah s uw m d
assure	ah sh uh r #1
assured	ah sh uh r d
assuredly	ah sh uh r ah d l iy
assures	ah sh uh r z
assuring	ah sh uh r ih ng
asthma	ae z m ah
astonishingly	ah s t aa n ih sh ih ng l iy
astronomy	ah s t r aa n ah m iy
astrophysics	ae s t r ah f ih z ih k s
at	ae t #1
ate	ey t #1
atheists	ey th iy ih s t s
athletic	ae th l eh t ih k
atmosphere	ae t m ah s f ih r
atomic	ah t aa m ih k
atoms	ae t m z
atop	ah t aa p
attach	ah t ae ch
attack	ah t ae k #1
attacked	ah t ae k t
attempted	ah t eh m p t ih d
attendance	ah t eh n d ih n s
attendants	ah t eh n d eh n t s
attention	ah t eh n sh ih n
attitude	ae t ih t uw d
attracted	ah t r ae k t ih d
attractive	ah t r ae k t ih v
attributed	ae t r ih b y uh t ih d
atypical	ey t ih p ih k l
auburn	aa b er n
audience	aa d iy ah n s
audio	aa d iy ow #1
audio-visual	aa d iy ow v ih sh uw l
audition	aa d ih sh ih n
auditors	aa d ih t er z
auditory	aa d ih t aa r iy
audits	aa d ih t s
augmented	aa g m eh n t ih d
aunt	ae n t #2
austere	aa s t ih r
author	aa th er #1
author's	aa th er z
authorities	ah th aa r ih t iy z
authority	ah th aa r ih t iy #1
authorization	aa th er ih z ey sh ih n
authorized	aa th er ay z d
autistic	aa t ih s t ih k
autofluorescence	aa t ow f l uh r eh s n s
autographs	aa t ih g r ae f s
automatic	aa t ah m ae t ih k
automobile	aa t ah m ow b iy l
autonomy	aa t aa n ah m iy
autumn	aa t m
available	ah v ey l ih b l
avalanche	ae v ah l ae n ch
average	ae v r ih jh
avocado	ae v ah k aa d ow #1
avocados	ae v ah k aa d ow z
avoid	ah v oy d #1
avoided	ah v oy d ih d
avoiding	ah v oy d ih ng
avowed	ah v aw d
aw	aa #1
awards	ah w aa r d z
aware	ah w ae r
away	ah w ey
awe	aa #2
awe-inspiring	aa ih n s p ay er ih ng
awkward	aa k w er d
awoke	ah w ow k
axis	ae k s ih s
babbled	b ae b l d
baboon's	b ae b uw n z
back	b ae k #1
backed	b ae k t #1
backgrounds	b ae k g r aw n d z
backward	b ae k w er d z
backyards	b ae k y aa r d z
bacteria	b ae k t ih r iy ah
bad	b ae d #1
badness	b ae d n ih s
baffle	b ae f l
bag	b ae g #1
bagpipes	b ae g p ay p s
bags	b ae g z
bake	b ey k
balance	b ae l ih n s
bale	b ey l #1
baleful	b ey l f l
ball	b aa l #1
ballet	b ae l ey #1
ballets	b ae l ey z
balloons	b ah l uw n z
ballplayer	b aa l p l ey er
balls	b aa l z
ballyhoo	b ae l iy hh uw
bandaged	b ae n d ih jh d
bandages	b ae n d ih jh ih z
bank	b ae ng k #1
bankers	b ae ng k er z
banks	b ae ng k s
barb	b aa r b #1
barb's	b aa r b z
barbaric	b aa r b ae r ih k
barbecue	b aa r b ih k y uw
barbed	b aa r b d
bare	b ae r #1
barely	b ae r l iy
bargains	b aa r g ih n z
bark	b aa r k
barley	b aa r l iy
barn	b aa r n #1
barometric	b ae r ah m eh t r ih k
barracuda	b ae r ah k uw d ah
barrels	b ae r l z
barricades	b ae r ah k ey d z
barriers	b ae r iy er z
base	b ey s #1
baseball	b ey s b aa l #1
baseball's	b ey s b aa l z
based	b ey s t
basic	b ey s ih k
basis	b ey s ih s
basketball	b ae s k ih t b aa l
bath	b ae th #1
bathe	b ey dh #1
bathing	b ey dh ih ng
baths	b ae th s
bathtubs	b ae th t ah b z
battery	b ae t er iy #1
battery-powered	b ae t er iy p aw er d
batting	b ae t ih ng
bay	b ey #1
bayed	b ey d
bayonet	b ey ah n eh t
bayou	b ay uw
bazaar	b ah z aa r #1
be	b iy #1
beach	b iy ch
beans	b iy n z
beard	b ih r d
beat	b iy t #1
beatniks	b iy t n ih k s
beautiful	b y uw t ih f l
beautifully	b y uw t ih f ah l iy
beauty	b y uw t iy
becalmed	b ih k aa m d
became	b ih k ey m
because	b ih k aa z
beckons	b eh k ih n z
become	b ih k ah m #1
becomes	b ih k ah m z
becoming	b ih k ah m ih ng
bed	b eh d #1
bedlam	b eh d l ah m
bedroom	b eh d r uw m #1
bedrooms	b eh d r uw m z
beds	b eh d z
beefsteak	b iy f s t ey k
been	b ih n #1
beep	b iy p
beer	b ih r #1
beers	b ih r z
before	b ah f aa r
beg	b eh g #1
began	b iy g ae n
beggar	b eh g er
begin	b ah g ih n #1
beginning	b ah g ih n ih ng
begins	b ah g ih n z
behaved	b ih hh ey v d
behavior	b ih hh ey v y er
behind	b ah hh ay n d
being	b iy ih ng
belched	b eh l ch t
believe	b ah l iy v #1
believed	b ah l iy v d
bellhops	b eh l hh aa p s
bellows	b eh l ow z
bells	b eh l z
belong	b ah l aa ng #1
belongs	b ah l aa ng z
beloved	b ah l ah v ah d
below	b ah l ow
belt	b eh l t
bench	b eh n ch
beneath	b ih n iy th
benefit	b eh n ah f ih t #1
benefits	b eh n ah f ih t s
bequests	b ih k w eh s t s
bereft	b er eh f t
beside	b ah s ay d #1
besides	b ah s ay d z
best	b eh s t
bet	b eh t #1
betide	b ah t ay d
betrayed	b iy t r ey d
better	b eh t er
between	b ah t w iy n
beverage	b eh v r ih jh #1
beverages	b eh v r ih jh ih z
beyond	b iy aa n d
biased	b ay ih s t
biblical	b ih b l ih k l
bibliographies	b ih b l iy aa g r ah f iy z
bickering	b ih k er ih ng
bidding	b ih d ih ng
big	b ih g #1
bigger	b ih g er
bike	b ay k
bill	b ih l #1
billowed	b ih l ow d
bills	b ih l z
binomial	b ay n ow m iy l
biological	b ay ah l aa jh ih k l
biologists	b ay aa l ah jh ih s t s
biology	b ay aa l ah jh iy
biracial	b ay r ey sh l
birds	b er d z
birth	b er th #1
birthday	b er th d ey
biscuit	b ih s k ih t
bit	b ih t #1
bites	b ay t s
bitter	b ih t er
bivouac	b ih v w ae k
bizarre	b ah z aa r #2
black	b l ae k #1
blackened	b l ae k ih n d
blame	b l ey m
blank	b l ae ng k #1
blankets	b l ae ng k ih t s
blasphemous	b l ae s f ah m ah s
blastdown	b l ae s t d aw n
bleachers	b l iy ch er z
blend	b l eh n d
bleu	b l uw #1
blew	b l uw #2
blindness	b l ay n d n ih s
blissful	b l ih s f l
blistered	b l ih s t er d
blitz	b l ih t s
bloat	b l ow t
block	b l aa k #1
blockade	b l aa k ey d
blocks	b l aa k s
blonde	b l aa n d
blooded	b l ah d ih d
blouses	b l aw s ih z
blow	b l ow #1
blowers	b l ow er z
blowing	b l ow ih ng
blue	b l uw #3
bluejay	b l uw jh ey
blues	b l uw z
bluffs	b l ah f s
bluing	b l uw ih ng
bluish	b l uw ih sh
blunt	b l ah n t #1
bluntly	b l ah n t l iy
board	b aa r d #1
boardinghouses	b aa r d ih ng hh aw z ih z
boat	b ow t #1
boat's	b ow t s
bob	b aa b #1
bobby	b aa b iy
bobcat	b aa b k ae t
bodied	b aa d iy d
bodies	b aa d iy z
body	b aa d iy #1
bog	b aa g #1
bogged	b aa g d
boil	b oy l #1
boiling	b oy l ih ng
bold	b ow l d
bolt	b ow l t
bomb	b aa m #1
bombs	b aa m z
bone	b ow n #1
bones	b ow n z
bonfire	b aa n f ay er
bongos	b aa ng g ow z
book	b uh k #1
books	b uh k s
boom	b uw m #1
boomerang	b uw m er ae ng
boost	b uw s t
bootleggers	b uw t l eh g er z
boots	b uw t s
bored	b aa r d #2
boring	b aa r ih ng
born	b aa r n #2
borrow	b aa r ow
boss	b aa s #1
boston	b aa s t n
both	b ow th
bother	b aa dh er #1
bothers	b aa dh er z
bottle	b aa t l
bottom	b aa t m #1
bottomed	b aa t m d
bought	b aa t #1
bounce	b aw n s
bounded	b aw n d ih d
bounds	b aw n d z
bourgeois	b uh r sh w aa
bowl	b ow l #1
box	b aa k s
boy	b oy #1
boy's	b oy z #1
boys	b oy z #2
bracelet	b r ey s l ih t
braiding	b r ey d ih ng
brain	b r ey n
brakes	b r ey k s
branch	b r ae n ch
brand	b r ae n d
brave	b r ey v
bread	b r eh d
break	b r ey k #1
breakdown	b r ey k d aw n
breakfast	b r eh k f ih s t
breaking	b r ey k ih ng
breast	b r eh s t
breath	b r eh th #1
breathed	b r iy dh d
breathlessly	b r eh th l ah s l iy
breed	b r iy d
breeze	b r iy z
brick	b r ih k #1
bricks	b r ih k s
bridal	b r ay d l
bride	b r ay d #1
bride's	b r ay d z
bridge	b r ih jh #1
bridges	b r ih jh ih z
brief	b r iy f #1
briefly	b r iy f l iy
bright	b r ay t #1
brighter	b r ay t er
brightly	b r ay t l iy
brim	b r ih m
bring	b r ih ng #1
brings	b r ih ng z
bristles	b r ih s l z
broccoli	b r aa k ah l iy
brochure	b r ow sh uh r
broil	b r oy l
broke	b r ow k #1
broken	b r ow k ih n
bronc	b r aa ng k
brother	b r ah dh er #1
brother's	b r ah dh er z
brought	b r aa t
brown	b r aw n
brows	b r aw z
bruises	b r uw z ih z
brush	b r ah sh #1
brushy	b r ah sh iy
bubbles	b ah b l z
buckle	b ah k l
buddies	b ah d iy z
buddy	b ah d iy #1
buff	b ah f #1
buffalo	b ah f ah l ow
bugeyed	b ah g ay d
bugged	b ah g d
bugle	b y uw g l
build	b ih l d #1
builders	b ih l d er z
building	b ih l d ih ng #1
buildings	b ih l d ih ng z
built	b ih l t
bulged	b ah l jh d
bull	b uh l #1
bull-like	b uh l l ay k
bullet	b uh l ih t #1
bullets	b uh l ih t s
bum	b ah m #1
bump	b ah m p
bungalow	b ah ng g ah l ow
bunks	b ah ng k s
buns	b ah n z
bureaucracy	b y er aa k r ih s iy
burglar	b er g l er
burn	b er n #1
burned	b er n d
burner	b er n er
burning	b er n ih ng
burst	b er s t #1
bursting	b er s t ih ng
bury	b eh r iy
bus	b ah s #1
bushel	b uh sh l
business	b ih z n ih s
busy	b ih z iy
but	b ah t #1
butcher	b uh ch er
butter	b ah t er #1
butterfly	b ah t er f l ay
butterscotch	b ah t er s k aa ch
buttonholes	b ah t n hh ow l z
buttons	b ah t n z
buy	b ay #1
buyer	b ay er
buying	b ay ih ng
buys	b ay z
buzz	b ah z #1
buzzing	b ah z ih ng
by	b ay #2
c'mon	k ah m aa n
cab	k ae b #1
cabinets	k ae b ih n ih t s
cable	k ey b l
cafe	k ae f ey
cafeteria	k ae f ah t ih r iy ah
cage	k ey jh
calcium	k ae l s iy ah m
calendar	k ae l ih n d er #1
calendars	k ae l ih n d er z
calf	k ae f #1
calico	k ae l ih k ow
call	k aa l #1
called	k aa l d
calling	k aa l ih ng
calls	k aa l z
calm	k aa m #1
came	k ey m
cameo	k ae m iy ow
camera	k ae m er ah
camp	k ae m p #1
camping	k ae m p ih ng
campus	k ae m p ah s
can	k ae n #1
can't	k ae n t #1
candies	k ae n d iy z
candles	k ae n d l z
candy	k ae n d iy #1
canister	k ae n ih s t er
canned	k ae n d #1
cannot	k ae n aa t
canoes	k ah n uw z
cantaloupe	k ae n t ah l ow p
canteen	k ae n t iy n
canter	k ae n t er
cap'n	k ae p n
capable	k ey p ah b l
capillary	k ae p ah l eh r iy
capital	k ae p ih t l #1
capitalists	k ae p ih t l ih s t s
capitalize	k ae p ah t ah l ay z
capsule	k ae p s l
captain	k ae p t ih n
captured	k ae p ch er d
car	k aa r #1
car's	k aa r z #1
caraway	k ae r ah w ey
cardboard	k aa r d b aa r d
cards	k aa r d z
care	k ae r #1
carefree	k ae r f r iy
careful	k ae r f l
carefully	k ae r f uh l iy
carl	k aa r l
carol	k ae r l
carpenter	k aa r p ah n t er
carpet	k aa r p ah t
carriage	k ae r ih jh
carried	k ae r iy d
carries	k ae r iy z
carry	k ae r iy #1
carrying	k ae r iy ih ng
cars	k aa r z #2
cart	k aa r t #1
cartilage	k aa r t l ih jh
cartoon	k aa r t uw n #1
cartoons	k aa r t uw n z
carved	k aa r v d
case	k ey s #1
cases	k ey s ih z
cash	k ae sh #1
cashmere	k ae sh m ih r
cassandra	k ah s ae n d r ah
cast	k ae s t #1
castor	k ae s t er
castorbeans	k ae s er b iy n z
casual	k ae sh uw l
casually	k ae sh uw ah l iy
cat	k ae t #1
cat's	k ae t s #1
catastrophic	k ae t ih s t r aa f ih k
catch	k ae ch
categories	k ae t ah g aa r iy z
catkins	k ae t k ih n z
cats	k ae t s #2
cattle	k ae t l
caught	k aa t #1
cauliflower	k aa l ih f l aw er
caused	k aa z d
causes	k aa z ih z
causeway	k aa z w ey
caution	k aa sh ih n
cavity	k ae v ah t iy
cease	s iy s #1
cease-fire	s iy s f ay er
ceiling	s iy l ih ng
celebrate	s eh l ih b r ey t #1
celebrates	s eh l ih b r ey t s
cellophane	s eh l ah f ey n
cells	s eh l z
cement	s ih m eh n t
censorship	s eh n s er sh ih p
census	s eh n s ih s
cent	s eh n t #1
centered	s eh n t er d
centering	s eh n t er ih ng
central	s eh n t r l
centre	s eh n t er #1
centrifuge	s eh n t r ah f y uw jh
cents	s eh n t s
centuries	s eh n ch er iy z
century	s eh n ch er iy #1
ceramic	s er ae m ih k
cereal	s ih r iy l
cerebral	s er iy b r ah l
certain	s er t n #1
certainly	s er t n l iy
chablis	sh ae b l iy
chain	ch ey n #1
chair	ch ae r #1
chairs	ch ae r z
challenge	ch ae l ih n jh #1
challenged	ch ae l ih n jh d
chamber	ch ey m b er
chance	ch ae n s
change	ch ey n jh #1
changed	ch ey n jh d
changes	ch ey n jh ih z
changing	ch ey n jh ih ng
chaos	k ey aa s
character	k ae r ah k t er #1
characteristics	k ae r ah k t er ih s t ih k s
characters	k ae r ah k t er z
charge	ch aa r jh #1
charged	ch aa r jh d
charlie's	ch aa r l iy z
charm	ch aa r m #1
charmer	ch aa r m er
chart	ch aa r t #1
chases	ch ey s ih z
chasing	ch ey s ih ng
chastity	ch ae s t ih t iy
chattering	ch ae t er ih ng
chauffeur	sh ow f er #1
chauffeur-driven	sh ow f er d r ih v n
chaw	ch aa #1
cheap	ch iy p
cheating	ch iy t ih ng
check	ch eh k #1
checked	ch eh k t
cheek	ch iy k
cheese	ch iy z
cheetal	ch iy t l
chemical	k eh m ih k l #1
chemicals	k eh m ih k l z
chest	ch eh s t #1
chestnuts	ch eh s n ah t s
chests	ch eh s t s
chew	ch uw #1
chicken	ch ih k ih n
chief	ch iy f #1
chiefly	ch iy f l iy
child	ch ay l d #1
childhood	ch ay l d hh uh d
children	ch ih l d r ah n
chilled	ch ih l d #1
chills	ch ih l z
chip	ch ih p #1
chipper	ch ih p er
chives	ch ay v z
chloride	k l aa r ay d
chlorine	k l aa r iy n
chocolate	ch aa k l ih t
choices	ch oy s ih z
choir	k w ay er
choke	ch ow k
choose	ch uw z #1
choosing	ch uw z ih ng
chop	ch aa p #1
chopped	ch aa p t
choreographer	k aa r iy aa g r ah f er
chortled	ch aa r t l d
chorused	k aa r ih s t
chose	ch ow z #1
chosen	ch ow z n
chrome	k r ow m
chroniclers	k r aa n ih k l er z
chronological	k r aa n ah l aa jh ih k l
chronologically	k r aa n ah l aa jh ih k ah l iy
chuck	ch ah k #1
chuckled	ch ah k l d
church	ch er ch
cigar	s ih g aa r
cigarette	s ih g er eh t #1
cigarettes	s ih g er eh t s
cinch	s ih n ch
cinematic	s ih n ah m ae t ih k
circle	s er k l #1
circled	s er k l d
circumstances	s er k ah m s t ae n s ih z
citizen	s ih t ih z ih n #1
citizenship	s ih t ih z ih n sh ih p
city	s ih t iy
civil	s ih v l #1
civilian	s ah v ih l y ah n
civilization	s ih v l ah z ey sh ih n
civilized	s ih v l ay z d
claimed	k l ey m d
clamp	k l ae m p
clams	k l ae m z
clamshell	k l ae m sh eh l
clapping	k l ae p ih ng
clarification	k l ae r ah f ah k ey sh ih n
clarified	k l ae r ah f ay d
clarify	k l ae r ah f ay #1
clashed	k l ae sh t
clasp	k l ae s p #1
clasped	k l ae s p t
class	k l ae s #1
class-biased	k l ae s b ay ih s t
classical	k l ae s ih k l
classrooms	k l ae s r uw m z
clatter	k l ae t er
clause	k l aa z #1
clay	k l ey #1
clean	k l iy n #1
cleaned	k l iy n d
cleaners	aa l iy n er z
cleaning	k l iy n ih ng
cleans	k l iy n z
clear	k l ih r #1
cleared	k l ih r d
clearer	k l ih r er
clearing	k l ih r ih ng
clearly	k l ih r l iy
clerk's	k l er k s #1
clerks	k l er k s #2
clever	k l eh v er
cliff	k l ih f #1
cliff's	k l ih f s
climates	k l ay m ah t s
climax	k l ay m ae k s
climbed	k l ay m d
climbing	k l ay m ih ng
clinches	k l ih n ch ih z
cling	k l ih ng
clockwork	k l aa k w er k
closer	k l ow s er
closet	k l aa z ih t
close~adj	k l ow s #1
close~v	k l ow z #1
closing	k l ow z ih ng
clot	k l aa t #1
cloth	k l aa th
clothes	k l ow dh z #1
clotheshorse	k l ow dh z hh aa r s
clothing	k l ow dh ih ng
clotted	k l aa t ih d
cloud	k l aw d #1
cloudburst	k l aw d b er s t
clouds	k l aw d z
cloverleaf	aa l ow v er l iy f
club	k l ah b
clumsy	k l ah m z iy
coach	k ow ch
coagulating	k ow ae g y uh l ey t ih ng
coal	k ow l #1
coal-black	k ow l b l ae k
coalition	k ow ah l ih sh ih n
coals	k ow l z
coast	k ow s t
coat	k ow t
coauthors	k ow aa th er z
cobbler's	k aa b l er z
coconut	k ow k ah n ah t #1
coconuts	k ow k ah n ah t s
code	k ow d #1
codes	k ow d z
coeducational	k ow eh jh ih k ey sh ih n l
coexist	k ow ih g z ih s t
coffee	k aa f iy
coffers	k aa f er z
coil	k oy l
coin	k oy n #1
coincided	k ow ih n s ay d ih d
coins	k oy n z
coke	k ow k #1
cold	k ow l d #1
cold-blooded	k ow l d b l ah d ih d
coleslaw	k ow l s l aa
collared	k aa l er d
colleagues	k aa l iy g z
collection	k ah l eh k sh ih n
collects	k ah l eh k t s
colleges	k aa l ih jh z
collie	k aa l iy #1
collusion	k ah l uw sh ih n
color	k ah l er #1
colored	k ah l er d
colorful	k ah l er f l
colossal	k ah l aa s l
column	k aa l m
combine	k ah m b ay n
combustion	k ah m b ah s ch n
come	k ah m #1
comes	k ah m z
coming	k ah m ih ng
command	k ah m ae n d
comment	k aa m eh n t
commercial	k ah m er sh l
common	k aa m ah n #1
commonplace	k aa m ah n p l ey s
communism	k aa m y uw n ih z m
community	k ah m y uw n ih t iy
compact	k aa m p ae k t
companions	k ah m p ae n y ih n z
company	k ah m p ah n iy #1
company's	k ah m p ah n iy z
comparable	k aa m p er ah b l
compare	k ah m p ae r #1
comparison	k ah m p ae r ih s ih n
compensation	k aa m p ah n s ey sh ih n
competently	k aa m p ah t ih n t l iy
competing	k ah m p iy t ih ng
competition	k aa m p ah t ih sh ih n
competitive	k ah m p eh t ih t ih v
competitors	k ah m p eh t ih t er z
compile	k ah m p ay l
complete	k ah m p l iy t #1
completely	k ah m p l iy t l iy
complex	k ah m p l eh k s #1
complexity	k ah m p l eh k s ih t iy
compliance	k ah m p l ay ih n s
complicated	k aa m p l ah k ey t ih d
complicity	k ah m p l ih s ih t iy
compose	k ah m p ow z
composition	k aa m p ah z ih sh ih n #1
compositions	k aa m p ah z ih sh ih n z
compost	k aa m p ow s t
composure	k ah m p ow sh er
compound	k aa m p aw n d #1
compounded	k aa m p aw n d ih d
compounds	k aa m p aw n d z
compresses	k aa m p r eh s ih z
compulsion	k ah m p ah l sh ih n
compulsory	k ah m p ah l s er iy
computer	k ah m p y uw t er #1
computers	k ah m p y uw t er z
comrades	k aa m r ae d z
conceivably	k ah n s iy v ah b l iy
conceived	k ah n s iy v d
concept	k aa n s eh p t
concern	k ah n s er n #1
concerns	k ah n s er n z
concert	k aa n s er t
concessionaire	k ah n s eh sh ih n ae r
conclusion	k ah n k l uw sh ih n #1
conclusions	k ah n k l uw sh ih n z
concrete	k aa n k r iy t
concurrent	k ah n k er ah n t
condemns	k ah n d eh m z
condition	k ah n d ih sh ih n #1
conditions	k ah n d ih sh ih n z
confabulation	k ah n f ae b y uh l ey sh ih n
conferences	k aa n f er ah n s ih z
confidence	k aa n f ih d ih n s
confident	k aa n f ih d ih n t
confidential	k aa n f ih d eh n sh l
configuration	k ah n f ih g y er ey sh ih n
confines	k aa n f ay n z
confirm	k ah n f er m
confirmation	k aa n f er m ey sh ih n #1
conformational	k aa n f er m ey sh ih n l
conformists	k ah n f aa r m ih s t s
confronted	k ah n f r ah n t ih d
confusion	k ah n f y uw sh ih n
congestion	k ah n jh eh s ch ih n
congratulate	k ah n g r ae ch ah l ey t
congregation	k aa ng g r ih g ey sh ih n
conjured	k aa n jh er d
connoisseur	k aa n ih s er
conscience	k aa n sh ih n s
consequences	k aa n s ih k w eh n s ih z
conservatism	k ah n s er v ah t ih z m
consider	k ah n s ih d er #1
considerable	k ah n s ih d er ah b l #1
considerably	k ah n s ih d er ah b l iy
considered	k ah n s ih d er d
considering	k ah n s ih d er ih ng
consistently	k ah n s ih s t ih n t l iy
consists	k ah n s ih s t s
consolidation	k ah n s aa l ah d ey sh ih n
conspicuous	k ah n s p ih k y uw ah s
constantly	aa aa n s t ih n t l iy
construction	k ah n s t r ah k sh ih n #1
constructions	k ah n s t r ah k sh ih n z
consume	k ah n s uw m #1
consumers	k ah n s uw m er z
consuming	k ah n s uw m ih ng
consumption	k ah n s ah m p sh ih n
contact	k aa n t ae k t
contagious	k ah n t ey jh ih s
contain	k ah n t ey n #1
contained	k ah n t ey n d
container	k ah n t ey n er
contains	k ah n t ey n z
contemporary	k ah n t eh m p er eh r iy
contentedly	k ah n t eh n t ih d l iy
continental	k aa n t n eh n t l
continue	k ah n t ih n y uw #1
continued	k ah n t ih n y uw d
continues	k ah n t ih n y uw z
continuing	k ah n t ih n y uw ih ng
continuous	k ah n t ih n y uw ah s #1
continuously	k ah n t ih n y uw ah s l iy
contradictorily	k aa n t r ah d ih k t aa r ah l iy
contrary	k aa n t r eh r iy
contrast	k aa n t r ae s t
contribute	k ah n t r ih b y uw t #1
contributed	k ah n t r ih b y uw t ih d
contributions	k aa n t r ah b y uw sh ih n z
contributory	k ah n t r ih b y uw t aa r iy
control	k ah n t r ow l #1
controlled	k ah n t r ow l d
controls	k ah n t r ow l z
convenient	k ah n v iy n y n t
converted	k ah n v er t ih d
convey	k ah n v ey
conviction	k ah n v ih k sh ih n
convince	k ah n v ih n s #1
convincing	k ah n v ih n s ih ng
cook	k uh k #1
cooked	k uh k t #1
cooked-over	k uh k t ow v er
cookies	k uh k iy z
cooking	k uh k ih ng
cool	k uw l
cooperated	k ow aa p er ey t ih d
cooperates	k ow aa p er ey t s
cooperation	k ow aa p er ey sh ih n
cooperative	k ow aa p er ih t ih v
cop	k aa p #1
copper	k aa p er
copra	k ow p r ah
copy	k aa p iy
cordial	k aa r jh l
corduroy	k aa r d er oy
corn	k aa r n #1
corner	k aa r n er #1
cornered	k aa r n er d
cornmeal	k aa r n m iy l
corollaries	k aa r ah l eh r iy z
correct	k er eh k t
corrugated	k aa r ah g ey t ih d
corsage	k aa r s aa sh
cory	k aa r iy #1
cosmetics	k aa z m eh t ih k s
cost	k aa s t #1
costly	k aa s t l iy
costs	k aa s t s
costume	k aa s t uw m #1
costumes	k aa s t uw m z
cottage	k aa t ih jh
cotton	k aa t n
cough	k aa f #1
could	k uh d #1
could've	k uh d ah v
couldn't	k uh d n t
count	k aw n t #1
counted	k aw n t ih d
counties	k aw n t iy z
country	k ah n t r iy
countryside	aa ah n t r iy s ay d
county	k aw n t iy #1
couples	k ah p l z
courier	k er iy er
course	k aa r s #1
court	k aa r t #2
courts	k aa r t s
courtyard	k aa r t y aa r d
cover	k ah v er #1
coverage	k ah v er ih jh
covered	k ah v er d
covers	k ah v er z
cow	k aw #1
coward	k aw er d
cowboy	k aw b oy #1
cowboy's	k aw b oy z
cowling	k aw l ih ng
cows	k aw z
coy	k oy #1
coyote	k ay ow t iy
crab	k r ae b
crack	k r ae k #1
cracked	k r ae k t
craft	k r ae f t
cranberry	k r ae n b eh r iy
crash	k r ae sh #1
crashed	k r ae sh t
crashing	k r ae sh ih ng
crave	k r ey v
crawling	k r aa l ih ng
crayons	k r ey aa n z
crazily	k r ey z ih l iy
crazy	k r ey z iy
cream	k r iy m
create	k r iy ey t #1
created	k r iy ey t ih d
creation	k r iy ey sh ih n
credit	k r eh d ih t
creeping	k r iy p ih ng
creole	k r iy ow l
crept	k r eh p t
crest	k r eh s t #1
crestfallen	k r eh s t f aa l ih n
crew	k r uw #1
crimson	k r ih m z ih n
crisis	k r ay s ih s
crisp	k r ih s p
criss-	k r ih s #1
criss-cross	k r ih s k r aa s #1
crisscrossed	k r ih s k r aa s t
critical	k r ih t ih k l
crooked	k r uh k ih d
crops	k r aa p s
cross	k r aa s #1
crossed	k r aa s t
crossings	k r aa s ih ng z
crossroads	k r aa s r ow d z
crowd	k r aw d
crown	k r aw n
crucial	k r uw sh l
crucified	k r uw s ah f ay d
crude	k r uw d #1
crudely	k r uw d l iy
cruel	k r uw l #1
cruelty	k r uw l iy
crunched	k r ah n ch t
crushed	k r ah sh t
crushers	k r ah sh er z
cry	k r ay #1
crystalline	k r ih s t l ay n
crystallizing	k r ih s t l ay z ih ng
cubic	k y uw b ih k
cuisine	k w ih z iy n
cultivated	k ah l t ih v ey t ih d
cultural	k ah l ch er ah l
cultures	k ah l ch er z
cupcakes	k ah p k ey k s
cups	k ah p s
cure	k y uh r #1
cured	k y uh r d
curiosity	k y uh r iy aa s ih t iy
curious	k y uh r iy ah s
curiously	k y uh r iy ih s l iy
curly	k er l iy
current	k er ah n t
curry	k er iy #1
curve	k er v #1
curves	k er v z
custody	k ah s t ih d iy
customer	k ah s t ah m er #1
customers	k ah s t ah m er z
cut	k ah t #1
cutbacks	k ah t b ae k s
cuts	k ah t s
cutting	k ah t ih ng
cyclical	s ih k l ih k l
cynics	s ih n ih k s
dad	d ae d
daily	d ey l iy
damage	d ae m ih jh #1
damaged	d ae m ih jh d
damp	d ae m p
dance	d ae n s #1
dancers	d ae n s er z
dances	d ae n s ih z
danger	d ey n jh er #1
dangerous	d ey n jh er ih s
dangers	d ey n jh er z
danny	d ae n iy
daphne's	d ae f n iy z
dark	d aa r k #1
darkness	d aa r k n ih s
darned	d aa r n d
dash	d ae sh
data	d ey t ah
date	d ey t #1
davy	d ey v iy
dawn	d aa n
day	d ey #1
daydreamed	d ey d r iy m d
days	d ey z
daytime	d ey t ay m
dead	d eh d #1
deadline	d eh d l ay n
deal	d iy l #1
dealers	d iy l er z
deans	d iy n z
dear	d ih r #1
death	d eh th
debts	d eh t s
debut	d ey b y uw
decadent	d eh k ih d ih n t
decaying	d ah k ey ih ng
decays	d ah k ey z
deceitful	d ih s iy t f l
deceiving	d ih s iy v ih ng
december	d ih s eh m b er
decide	d ih s ay d #1
decided	d ih s ay d ih d
decides	d ih s ay d z
decisions	d ih s ih sh ih n z
decisive	d ah s ay s ih v
deck	d eh k #1
decking	d eh k ih ng
declared	d ah k l ae r d
declining	d ah k l ay n ih ng
decorate	d eh k er ey t #1
decorated	d eh k er ey t ih d
decorative	d eh k er ih t ih v
decorator	d eh k er ey t er
decrease	d iy k r iy s
deduct	d ah d ah k t #1
deductible	d ah d ah k t ah b l
deed	d iy d
deep	d iy p #1
deeper	d iy p er
deeply	d iy p l iy
deer	d ih r #2
defects	d iy f eh k t s
defend	d ah f eh n d #1
defended	d ah f eh n d ih d
defense	d ah f eh n s #1
defensive	d ah f eh n s ih v
defiantly	d ah f ay ah n t l iy
define	d ih f ay n
definite	d eh f ah n ih t #1
definitely	d eh f ah n ih t l iy
degree	d ah g r iy #1
degrees	d ah g r iy z
delegated	d eh l ah g ey t ih d
delete	d ah l iy t
delicate	d eh l ih k ih t
delicious	d ah l ih sh ih s
delight	d ah l ay t #1
delightful	d ah l ay t f l
delineating	d ah l ih n iy ey t ih ng
delivering	d ah l ih v er ih ng
demand	d ah m ae n d #1
demanded	d ah m ae n d ih d
demands	d ah m ae n d z
demineralization	d ah m ih n er l ay z ey sh ih n
demonstration	d eh m ah n s t r ey sh ih n
dense	d eh n s #1
density	d eh n s ih t iy
denunciation	d ih n ah n s iy ey sh ih n
deny	d ah n ay
departments	d ah p aa r t m ah n t s
departure	d ah p aa r ch er
depend	d ah p eh n d
depicts	d ih p ih k t s
depletion	d ih p l iy sh ih n
depreciation	d ih p r iy sh iy ey sh ih n
deprive	d ih p r ay v
deputy	d eh p y uw t iy
dereliction	d eh r ah l ih k sh ih n
derived	d er ay v d
deriving	d er ay v ih ng
describe	d ih s k r ay b #1
described	d ih s k r ay b d
desegregate	d ih s eh g r ih g ey t
desegregation	d iy s eh g r ih g ey sh ih n
deserves	d ih z er v z
design	d ih z ay n #1
designer	d ih z ay n er
desirable	d ih z ay er ah b l
desire	d ih z ay er #1
desires	d ih z ay er z
desk	d eh s k
desolation	d eh s ah l ey sh ih n
despair	d ih s p ae r
desperately	d eh s p er ah t l iy
despised	d ih s p ay z d
despite	d ih s p ay t
dessert	d ih z er t #1
desserts	d ih z er t s
destiny	d eh s t ih n iy
destroy	d ih s t r oy #1
destroying	d ih s t r oy ih ng
detail	d iy t ey l #1
detailed	d iy t ey l d
details	d iy t ey l z
detectable	d ih t eh k ah b l
detective's	d ih t eh k t ih v z
determination	d ih t er m ah n ey sh ih n
determine	d ih t er m ah n #1
determined	d ih t er m ah n d
detract	d ih t r ae k t
develop	d ah v eh l ah p #1
developed	d ah v eh l ah p t
developing	d ah v eh l ah p ih ng
development	d ah v eh l ah p m ah n t
device	d ah v ay s
devour	d ah v aw r
dew	d uw #1
diagnosed	d ay ih g n ow s t
diagnosis	d ay ih g n ow s ih s
diagonally	d ay ae g ih n ah l iy
diagram	d ay ah g r ae m
diane	d ay ae n
diarrhoea	d ay er iy ah
dice	d ay s
dictators	d ih k t ey t er z
dictionary	d ih k sh ih n eh r iy
did	d ih d #1
didn't	d ih d n t
die	d ay #1
died	d ay d
diet	d ay ah t
differ	d ih f er #1
difference	d ih f er ah n s #1
differences	d ih f er ah n s ih z
different	d ih f er ah n t #1
differentiate	d ih f er eh n sh iy ey t
differently	d ih f er ah n t l y
difficult	d ih f ih k ah l t
dig	d ih g #1
dignity	d ih g n ih t iy
dim	d ih m
dime	d ay m #1
dimensions	d ah m eh n sh ih n z
dimes	d ay m z
diminish	d ah m ih n ih sh #1
diminishing	d ah m ih n ih sh ih ng
dingo	d ih ng g ow
dinner	d ih n er
diploma	d ah p l ow m ah
direction	d er eh k sh ih n #1
directional	d er eh k sh ih n l
directions	d er eh k sh ih n z
director	d er eh k t er #1
directory	d er eh k t er iy
dirt	d er t #1
dirty	d er t iy
disappeared	d ih s ah p iy r d
disappointed	d ih s ah p oy n t ih d
disapproval	d ih s ah p r uw v l
disapproves	d ih s ah p r uw v z
disaster	d ih z ae s t er
discard	d ih s k aa r d
discipline	d ih s ah p l ih n #1
disciplined	d ih s ah p l ih n d
disclaimer	d ih s k l ey m er
discount	d ih s k aw n t
discouraged	d ih s k er ih jh d
discouraging	d ih s k er ih jh ih ng
discovered	d ih s k ah v er d
discretionary	d ih s k r eh sh ih n eh r iy
discussion	d ih s k ah sh ih n #1
discussions	d ih s k ah sh ih n z
disease	d ih z iy z #1
diseases	d ih z iy z ih z
disguise	d ih s g ay z
disgusting	d ih s g ah s t ih ng
dish	d ih sh #1
dishes	d ih sh ih z
disk	d ih s k #1
disliked	d ih s l ay k t
dislikes	d ih s l ay k s
disobeyed	d ih s ow b ey d
dispel	d ih s p eh l
dispensing	d ih s p eh n s ih ng
dispersed	d ih s p er s t
displacement	d ih s p l ey s m ah n t
display	d ih s p l ey #1
displayed	d ih s p l ey d
dispute	d ih s p y uw t #1
disputes	d ih s p y uw t s
disregarding	d ih s r ih g aa r d ih ng
disrepair	d ih s r ih p ae r
dissolve	d ih z aa l v
distance	d ih s t ih n s #1
distances	d ih s t ih n s ih z
distaste	d ih s t ey s t
distinct	d ih s t ih ng t
distinguished	d ih s t ih ng g w ih sh t
distorted	d ih s t aa r t ih d
distracted	d ih s t r ae k t ih d
distress	d ih s t r eh s
distributed	d ih s t r ih b y uw t ih d
districts	d ih s t r ih k t s
disturb	d ih s t er b
ditches	d ih ch ih z
dive	d ay v
diversity	d ah v er s ih t iy
divided	d ah v ay d ih d
divinities	d ah v ih n ih t iy z
division	d ah v ih sh ih n
divorce	d ah v aa r s #1
divorced	d ah v aa r s t
divorcee	d ah v aa r s ey
do	d uw #2
doctor	d aa k t er #1
doctors	d aa k t er z
doctrine	d aa k t r ah n
documented	d aa k y uw m eh n t ih d
documents	d aa k y uw m ah n t s
dodging	d aa jh ih ng
does	d ah z #1
doesn't	d ah z n t
dog	d aa g #1
dogmatically	d aa g m ae t ih k ah l iy
dogs	d aa g z
doin'	d uw ih n
doing	d uw ih ng
doll	d aa l #1
dollar	d aa l er #1
dollar-and-cents	d aa l er ae n d s eh n t s
dollars	d aa l er z #1
dollars-and-cents	d aa l er z ae n d s eh n t s
dolphins	d aa l f ah n z
dome	d ow m
domestic	d ah m eh s t ih k
dominant	d aa m ih n ih n t
dominated	d aa m ih n ey t ih d
don't	d ow n t
donate	d ow n ey t #1
donated	d ow n ey t ih d
done	d ah n #1
door	d aa r #1
doors	d aa r z
doorways	d aa r w ey z
dormitories	d aa r m ah t aa r iy z
doses	d ow s ih z
double	d ah b l #1
double-glaze	d ah b l g l ey z
doubt	d aw t
dough	d ow #1
doused	d aw s t
down	d aw n #1
downpour	d aw n p aa r
downstairs	d aw n s t ae r z
downtown	d aw n t aw n
downward	d aw n w er d
dozen	d ah z n #1
drain	d r ey n
dramatic	d r ah m ae t ih k
drank	d r ae ng k
drastically	d r ae s t ih k l iy
draw	d r aa #1
drawing	d r aa ih ng
drawled	d r aa l d
drawn	d r aa n
dream	d r iy m #1
dreams	d r iy m z
drenched	d r eh n ch t
dress	d r eh s #1
dressing	d r eh s ih ng
dressy	d r eh s iy
drew	d r uw
dried	d r ay d
drift	d r ih f t #1
drifted	d r ih f t ih d
drifting	d r ih f t ih ng
drink	d r ih ng k #1
drinkers	d r ih ng k er z
drive	d r ay v #1
driven	d r ih v ah n
drivers	d r ay v er z
driving	d r ay v ih ng
drop	d r aa p #1
dropped	d r aa p t
drops	d r aa p s
drought	d r aw t
drove	d r ow v
drug	d r ah g #1
drug's	d r ah g z #1
drugs	d r ah g z #2
drugstore	d r ah g s t aa r
drunk	d r ah ng k #1
drunkard	d r ah ng k er d #1
drunkards	d r ah ng k er d z
drunkenness	d r ah ng k ah n ih s
dry	d r ay #1
drying	d r ay ih ng
dubious	d uw b iy ah s
duck	d ah k #1
ducks	d ah k s
due	d uw #3
dug	d ah g #1
dull	d ah l #1
dumb	d ah m #1
dumped	d ah m p t
duplicate	d uw p l ih k ih t
during	d uh r ih ng
dust	d ah s t #1
dusting	d ah s t ih ng
dutch	d ah ch
duty	d uw t iy
dwarf	d w aa r f
dwell	d w eh l
dyeing	d ay ih ng #1
dying	d ay ih ng #2
dynamics	d ay n ae m ih k s
dynastic	d ay n ae s t ih k
each	iy ch
eagerly	iy g er l iy
eagerness	iy g er n ih s
ear	ih r #1
earlier	er l iy er
early	er l iy #1
earn	er n #1
earnestly	er n ih s t l iy
ears	ih r z
earth	er th #1
earth's	er th s
earthenware	er th ah n w ae r
earthly	er th l iy
earthquake	er th k w ey k
ease	iy z #1
eased	iy z d
easier	iy z iy er
easily	iy z ah l iy
eastern	iy s t er n
easy	iy z iy #1
easygoing	iy z iy g ow ih ng
eat	iy t #1
eaten	iy t n
eating	iy t ih ng
eccentricity	eh k s eh n t r ih s ih t iy
echo	eh k ow
economic	eh k ih n aa m ih k #1
economically	eh k ih n aa m ih k l iy
economy	ih k aa n ah m iy
ecumenical	eh k y uh m eh n ih k l
edge	eh jh #1
edges	eh jh ih z
edgy	eh d jh iy
education	eh jh ih k ey sh ih n #1
educational	eh jh ih k ey sh ih n l
effect	ih f eh k t #1
effective	ih f eh k t ih v
effects	ih f eh k t s
efficiency	ih f ih sh ih n s iy
efficient	ih f ih sh ih n t
effort	eh f er t
egg	eh g #1
egg-sized	eh g s ay z d
eggs	eh g z
ego	iy g ow #1
egotist	iy g ow t ih s t
eight	ey t #2
eighteenth	ey t iy n th
either	iy dh er
elaborately	ah l ae b er ah t l iy
elbowing	eh l b ow ih ng
elderly	eh l d er l iy
election	ah l eh k sh ih n
electric	ah l eh k t r ih k #1
electrical	ah l eh k t r ih k l
electricity	ah l eh k t r ih s ih t iy
electron	ah l eh k t r aa n #1
electronic	ah l eh k t r aa n ih k
electrostatic	ah l eh k t r ah s t ae t ih k
elegant	eh l ih g ih n t
element	eh l ah m ah n t #1
elementary	eh l ah m eh n t er iy #1
elementary-school	eh l ah m eh n t er iy s k uw l
elements	eh l ah m ah n t s
elevator	eh l ah v ey t er
eleven	ah l eh v ah n
ellipsoids	ah l ih p s oy d
elm	eh l m
elongation	ih l aa ng g ey sh ih n
else	eh l s #1
elsewhere	eh l s w ae r
embankment	ih m b ae ng k m ah n t
emblem	eh m b l ah m
embodiment	eh m b aa d ih m ah n t
embracing	eh m b r ey s ih ng
emerge	ih m er jh #1
emergency	ih m er jh ih n s iy
emotion	ih m ow sh ih n #1
emotional	ih m ow sh ih n l
emotionally	ih m ow sh ih n ah l iy
emotions	ih m ow sh ih n z
emperor	eh m p er er
emphasis	eh m f ah s ih s
emphasize	eh m f ah s ay z #1
emphasized	eh m f ah s ay z d
emphysema	eh m f ah z iy m aa
empirical	ih m p ih r ih k l
employee	ih m p l oy iy #1
employees	ih m p l oy iy z
employment	ih m p l oy m ah n t
empty	eh m p t iy
enabling	ih n ey b l ih ng
enact	ih n ae k t
enamel	ih n ae m l
encamped	ih n k ae m p t
enclosed	eh n k l ow z d
encountered	ih n k aw n t er d
encourage	ih n k er ih jh #1
encouraged	ih n k er ih jh d
encyclopedias	ih n s ay k l ah p iy d iy ah z
end	eh n d #1
endeavored	ih n d eh v er d
ended	eh n d ih d
endosperm	eh n d ow s p er m
ends	eh n d z
endurance	eh n d uh r n s
enemy	eh n ah m iy
energy	eh n er jh iy
engine	eh n jh ih n #1
engineer	eh n jh ih n ih r #1
engineering	eh n jh ih n ih r ih ng
engineers'	eh n jh ih n ih r z
engulfed	eh n g ah l f t
enigma	ih n ih g m ah
enjoy	eh n jh oy #1
enjoyed	eh n jh oy d
enlightenment	ih n l ay t n m ah n t
enlisted	ih n l ih s t ih d
enormous	ih n aa r m ah s
enough	ih n ah f #1
enrich	ih n r ih ch
ensue	ih n s uw
enter	eh n t er #1
entertaining	eh n t er t ey n ih ng
enthusiastic	ih n th uw z iy ae s t ih k
entire	ih n t ay er #1
entirely	ih n t ay er l iy
entitle	ih n t ay t l
entity	eh n ih t iy
entries	eh n t r iy z
entropy	eh n t r ah p iy
entry	eh n t r iy #1
envelope	eh n v ah l ow p
environment	eh n v ay r ah n m ah n t #1
environments	eh n v ay r ah n m ah n t s
enzyme	eh n z ay m
ephemeral	eh f eh m er l
epidemic	eh p ah d eh m ih k
episode	eh p ah s ow d
equal	iy k w l #1
equally	iy k w l iy
equation	ih k w ey sh ih n
equipment	ah k w ih p m ah n t
equipped	ah k w ih p t
equivalent	ih k w ih v l ah n t
era	eh r ah
erect	ih r eh k t
erotic	ih r aa t ih k
errors	eh r er z
eruption	ih r ah p sh ih n
escalator	eh s k ah l ey t er
escape	eh s k ey p
esoteric	eh s ah t eh r ih k
especially	ih s p eh sh ah l iy
essay	eh s ey
essential	ih s eh n sh l
essentially	ih s eh n sh ah l iy
establish	ih s t ae b l ih sh #1
establishment	ih s t ae b l ih sh m ah n t
estimate	eh s t ih m ih t #1
estimates	eh s t ih m ih t s
etc.	eh t s eh t er ah
eternal	ih t er n l
eternity	ih t er n ih t iy
etiquette	eh t ih k ih t
evacuate	ih v ae k y uw ey t
evaluate	ih v ae l y uw ey t #1
evaluated	ih v ae l y uw ey t ih d
evaluation	ih v ae l y uw ey sh ih n
evasive	ih v ey s ih v
even	iy v ah n #1
evening	iy v n ih ng
evenly	iy v ah n l iy
events	ah v eh n t s
eventualities	ih v eh n ch uw ae l ih t iy z
eventually	ih v eh n ch uw ah l iy
ever	eh v er #1
ever-increasing	eh v er ih n k r iy s ih ng
every	eh v r iy #1
everybody	eh v r iy b ah d iy
everyone	eh v r iy w ah n
everything	eh v r iy th ih ng
evidence	eh v ih d ih n s
evident	eh v ih d ih n t
evocative	ih v aa k ah t ih v
evolve	ih v aa l v
exacerbated	ih g z ae s er b ey t ih d
exacerbations	ih g z ae s er b ey sh ih n z
exactly	ih g z ae k t l iy
exaggerated	ih g z ae jh er ey t ih d
exam	ih g z ae m #1
examination	ih g z ae m ih n ey sh ih n
examined	ih g z ae m ih n d
example	ih g z ae m p l #1
examples	ih g z ae m p l z
exboyfriend	eh k s b oy f r eh n d
excellent	eh k s l ah n t
except	ih k s eh p t
exception	ih k s eh p sh ih n
excess	eh k s eh s
exchange	ih k s ch ey n jh #1
exchanged	ih k s ch ey n jh d
excited	ih k s ay t ih d
excitement	ih k s ay t m ah n t
exciting	ih k s ay t ih ng
exclaiming	ih k s k l ey m ih ng
excluded	ih k s k l uw d ih d
exclusive	ih k s k l uw s ih v
execute	eh k s ih k y uw t
execution	eh k s ih k y uw sh ih n
executive	ih g z eh k y uw t ih v
exercise	eh k s er s ay z #1
exercises	eh k s er s ay z ih z
exhibited	ih g z ih b ah t ih d
exhibits	ih g z ih b ah t s
exhusband	eh k s hh ah z b ah n d
exist	ih g z ih s t #1
existed	ih g z ih s t ih d
existence	ih g z ih s t ih n s
existing	ih g z ih s t ih ng
exists	ih g z ih s t s
exotic	ih g z aa t ih k
expect	eh k s p eh k t #1
expectations	eh k s p eh k t ey sh ih n z
expected	eh k s p eh k t ih d
expecting	eh k s p eh k t ih ng
expects	eh k s p eh k t s
expense	eh k s p eh n s #1
expensive	eh k s p eh n s ih v
experience	ih k s p ih r iy ah n s #1
experienced	ih k s p ih r iy ah n s t
experiment	eh k s p eh r ah m ah n t #1
experiment's	eh k s p eh r ah m ah n t s #1
experimental	eh k s p eh r ah m eh n t ah l
experiments	eh k s p eh r ah m ah n t s #2
expertise	eh k s p er t iy z
expertly	eh k s p er t l iy
experts	eh k s p er t s
explain	ih k s p l ey n #1
explains	ih k s p l ey n z
explanation	eh k s p l ih n ey sh ih n
explicitly	ih k s p l ih s ih t l iy
exploring	ih k s p l aa r ih ng
explosion	ih k s p l ow sh ih n
export	eh k s p aa r t
exposed	ih k s p ow z d
exposure	ih k s p ow sh er
expression	ih k s p r eh sh ih n
expressway	ih k s p r eh s w ey
exquisite	eh k s k w ih z ih t
extended	ih k s t eh n d ih d
extending	ih k s t eh n d ih ng
extensive	ih k s t eh n s ih v
extent	ih k s t eh n t
extra	eh k s t r ah
extraordinary	ih k s t r aa r d n eh r iy
extremely	ih k s t r iy m l iy
exultantly	ih g z ah l t n t l iy
eye	ay #1
eyebrow	ay b r aw
eyedrops	ay d r aa p s
eyelids	ay l ih d z
eyes	ay z
eyestrain	ay s t r ey n
fabric	f ae b r ih k #1
fabrics	f ae b r ih k s
face	f ey s #1
faces	f ey s ih z
fact	f ae k t #1
factions	f ae k sh ih n z
factors	f ae k t er z
facts	f ae k t s
faculty	f ae k l t iy
faded	f ey d ih d
fail	f ey l #1
failed	f ey l d
fails	f ey l z
failure	f ey l y er
faint	f ey n t
fair	f ae r #1
fairly	f ae r l iy
fairy	f ae r iy
faith	f ey th
fall	f aa l #1
fallen	f aa l ih n
fallout	f aa l aw t
falls	f aa l z
false	f aa l s
falters	f aa l t er z
fame	f ey m #1
familiar	f ah m ih l y er
familiarity	f ah m ih l y ae r ah t iy
family	f ae m l iy
famous	f ey m ah s
fan	f ae n #1
fancier	f ae n s iy er
fancy	f ae n s iy #1
fangs	f ae ng z
far	f aa r #1
farm	f aa r m #1
farmer's	f aa r m er z #1
farmers	f aa r m er z #2
farmhouses	f aa r m hh aw z ih z
farmland	f aa r m l ae n d
farmyard	f aa r m y aa r d
farther	f aa r dh er
fasciculations	f ah s ih k y ah l ey sh ih n z
fascinating	f ae s n ey t ih ng
fashion	f ae sh ih n #1
fashioned	f ae sh ih n d
fast	f ae s t #1
fast-closing	f ae s t aa l ow z ih ng
fast-opening	f ae s t ow p ah n ih ng
faster	f ae s t er
fat	f ae t
father	f aa dh er #1
father's	f aa dh er z #1
fathers	f aa dh er z #2
fatigue	f ah t iy g #1
fatigued	f ah t iy g d
fatigues	f ah t iy g z
fault	f aa l t #1
faults	f aa l t s
favor	f ey v er #1
favorable	f ey v er ah b l
favorite	f ey v er ih t
fawn	f aa n
fear	f ih r #1
feared	f ih r d
fearful	f ih r f l
fears	f ih r z
feasible	f iy z ah b l
feast	f iy s t
feather	f eh dh er #1
feathered	f eh dh er d
feathers	f eh dh er z
features	f iy ch er z
feed	f iy d
feel	f iy l #1
feeling	f iy l ih ng #1
feelings	f iy l ih ng z
feels	f iy l z
feet	f iy t
fell	f eh l #1
fella	f eh l ah
fellowship	f eh l ow sh ih p
felt	f eh l t
female	f iy m ey l
fenced	f eh n s t
fences	f eh n s ih z
fermented	f er m eh n t ih d
ferries	f eh r iy z
fertilizers	f er t ah l ay z er z
fever	f iy v er #1
feverishly	f iy v er ih sh l iy
few	f y uw #1
fewer	f y uw er
fibers	f ay b er z
fibrosis	f ay b r ow s ih s
fiction	f ih k sh ih n
fiddles	f ih d l z
field	f iy l d #1
fields	f iy l d z
fieldwork	f iy l d w er k
fiercely	f ih r s l iy
fiercest	f ih r s ih s t
fiery	f ay r iy
fifteen	f ih f t iy n
fifth	f ih f th
fifty	f ih f t iy #1
fight	f ay t #1
fights	f ay t s
figure	f ih g y er #1
figured	f ih g y er d
figures	f ih g y er z
file	f ay l #1
files	f ay l z
fill	f ih l #1
filling	f ih l ih ng
film	f ih l m #1
films	f ih l m z
filtered	f ih l t er d
filtering	f ih l t er ih ng
final	f ay n l #1
finally	f ay n l iy
financing	f ay n ae n s ih ng
find	f ay n d #1
finding	f ay n d ih ng
finds	f ay n d z
fine	f ay n #1
fine-feathered	f ay n f eh dh er d
finger	f ih ng g er #1
fingerprints	f ih ng g er p r ih n t s
fingers	f ih ng g er z
finish	f ih n ih sh #1
finishing	f ih n ih sh ih ng
fire	f ay er #1
firebug	f ay er b ah g
firecrackers	f ay er k r ae k er z
fireplace	f ay er p l ey s
fires	f ay er z
firing	f ay er ih ng
firmly	f er m l iy
firmness	f er m n ih s
firms	f er m z
first	f er s t
fiscal	f ih s k l
fish	f ih sh #1
fishermen	f ih sh er m eh n
fishing	f ih sh ih ng
fist	f ih s t #1
fists	f ih s t s
fit	f ih t #1
fitfully	f ih t f l iy
five	f ay v #1
five-hundred	f ay v hh ah n d r ah d
fix	f ih k s #1
fixed	f ih k s t
fjords	f iy aa r d z
flag	f l ae g
flame	f l ey m
flash	f l ae sh #1
flashing	f l ae sh ih ng
flat	f l ae t #1
flat-bottomed	f l ae t b aa t m d
flawless	f l aa l ah s
flaxseed	f l ae k s iy d
fled	f l eh d
fleecy	f l iy s iy
flesh	f l eh sh
flew	f l uw #1
flexibility	f l eh k s ah b ih l ih t iy
flexible	f l eh k s ah b l
flickered	f l ih k er d
flies	f l ay z
flimsy	f l ih m z iy
flip	f l ih p
float	f l ow t
floc	f l aa k
flood	f l ah d
floor	f l aa r #1
floorboards	f l aa r b aa r d z
flopped	f l aa p t
flourish	f l ah r ih sh #1
flourishes	f l ah r ih sh ih z
flow	f l ow #1
flower	f l aw er #1
flowerpot	f l aw er p aa t
flowers	f l aw er z
flu	f l uw #2
fluent	f l uw ah n t
fluid	f l uw ih d
flurries	f l er iy z
fluttered	f l ah t er d
flying	f l ay ih ng
foam	f ow m #1
foamy	f ow m iy
focus	f ow k ih s
fog	f aa g
foil	f oy l
fold	f ow l d #1
folded	f ow l d ih d
folds	f ow l d z
follow	f aa l ow #1
followed	f aa l ow d
following	f aa l ow ih ng
follows	f aa l ow z
food	f uw d #1
foods	f uw d z
fool	f uw l #1
fooling	f uw l ih ng
foolish	f uw l ih sh
fools	f uw l z
foot	f uh t #1
football	f uh t b aa l
footfall	f uh t f aa l
footnotes	f uh t n ow t s
for	f aa r #2
forbidden	f aa r b ih d n
force	f aa r s #1
forced	f aa r s t
forces	f aa r s ih z
forecasts	f aa r k ae s t s
forehead	f aa r hh eh d
foreign	f aa r ah n #1
foreigners	f aa r ah n er z
forest	f aa r ih s t
forever	f er eh v er
forged	f aa r jh d
forgery	f aa r jh er iy
forget	f aa r g eh t
forgiveness	f aa r g ih v n ih s
forgot	f aa r g aa t
form	f aa r m #2
formality	f aa r m ae l ih t iy
formation	f aa r m ey sh ih n
formed	f aa r m d
former	f aa r m er #1
forms	f aa r m z
formula	f aa r m y uh l ah
formulation	f aa r m y uh l ey sh ih n
forth	f aa r th
fortune	f aa r ch ih n
forty	f aa r t iy #1
forty-seven	f aa r t iy s eh v ah n
forward	f aa r w er d
fosters	f aa s t er z
fought	f aa t
foul	f aw l
found	f aw n d
four	f aa r #3
frame	f r ey m #1
framework	f r ey m w er k
frankfurter	f r ae ng k f er t er #1
frankfurters	f r ae ng k f er t er z
frantically	f r ae n t ih k l iy
freed	f r iy d #1
freedom	f r iy d ah m
freely	f r iy l iy
freethinkers	f r iy th ih ng k er z
freeway	f r iy w ey
frequent	f r iy k w ah n t #1
frequently	f r iy k w ah n t l iy
fresh	f r eh sh
friend	f r eh n d #1
friends	f r eh n d z
frightened	f r ay t n d
fringe	f r ih n jh
frivolous	f r ih v l ah s
from	f r ah m
front	f r ah n t
frost	f r aa s t #1
frostbite	f r aa s t b ay t
frowningly	f r aw n ih ng l iy
froze	f r ow z
fruit	f r uw t
frustration	f r ah s t r ey sh ih n
fudge	f ah jh
fulfilling	f uh l f ih l ih ng
fulfillment	f uh l f ih l m ah n t
full	f uh l #1
fullness	f uh l n ih s
fully	f uh l iy
fumbled	f ah m b l d
fuming	f y uw m ih ng
fun	f ah n #1
function	f ah ng k sh ih n #1
functional	f ah ng k sh ih n l
fund	f ah n d #1
funding	f ah n d ih ng
funds	f ah n d z
fungicides	f ah n jh ih s ay d z
funnel	f ah n l
funny	f ah n iy
fur	f er #1
furiously	f y uh r iy ah s l iy
furnish	f er n ih sh
furrier	f er iy er
further	f er dh er
fuss	f ah s #1
future	f y uw ch er
gab	g ae b
gadfly	g ae d f l ay
gadget	g ae jh ih t
gag	g ae g
gain	g ey n #1
gained	g ey n d
gait	g ey t #1
gallant	g ae l ih n t
gallon	g ae l ih n #1
galoshes	g ah l aa sh ih z
galvanic	g ae l v ae n ih k
game	g ey m
gang	g ae ng #1
gangplank	g ae ng p l ae ng k
garage	g er aa sh
garbage	g aa r b ih jh
garden	g aa r d n #1
gardens	g aa r d n z
garlic	g aa r l ih k
garrisoned	g ae r ih s ih n d
gas	g ae s #1
gashes	g ae sh ih z
gassing	g ae s ih ng
gates	g ey t s
gateway	g ey t w ey
gathered	g ae dh er d
gathering	g ae dh er ih ng
gaudy	g aa d iy
gave	g ey v
gay	g ey #1
gazed	g ey z d
gear	g ih r
geeing	jh iy ih ng
geese	g iy s
general	jh eh n er l #1
general's	jh eh n er l z #1
generalizations	jh eh n er l ah z ey sh ih n z
generalize	jh eh n er ah l ay z
generally	jh eh n er ah l iy
generals	jh eh n er l z #2
generations	jh eh n er ey sh ih n z
generous	jh eh n er ih s #1
generously	jh eh n er ih s l iy
gentle	jh eh n t l #1
gentleman	jh eh n t l m ah n
gently	jh eh n t l iy
genuinely	jh eh n y uw ah n l iy
geocentricism	jh iy ah s eh n t r ih s ih z m
geographically	jh iy ah g r ae f ih k l iy
geological	jh iy ah l aa jh ih k l
george	jh aa r jh
get	g eh t #1
gets	g eh t s
getting	g eh t ih ng
ghetto	g eh t ow #1
ghettos	g eh t ow z
ghost	g ow s t #1
ghostlike	g ow s t l ay k
giant	jh ay ih n t #1
giants	jh ay ih n t s
gift	g ih f t #1
gifted	g ih f t ih d
gifts	g ih f t s
gigantic	jh ay g ae n t ih k
gin	jh ih n
giraffes	jh er ae f s
girl	g er l #1
girlie	g er l iy
girlishly	g er l ih sh l iy
girls	g er l z
give	g ih v #1
given	g ih v ah n #1
gives	g ih v z
givin'	g ih v ah n #2
gland	g l ae n d
glass	g l ae s
glaze	g l ey z #1
glazed	g l ey z d
glazing	g l ey z ih ng
gleam	g l iy m #1
gleamed	g l iy m d
gleaming	g l iy m ih ng
glee	g l iy #1
glee-club	g l iy k l ah b
glimpse	g l ih m p s
glistened	g l ih s n d
glistening	g l ih s n ih ng
gloom	g l uw m
glories	g l aa r iy z
glorified	g l aa r ih f ay d
glossy	g l aa s iy
gloves	g l ah v z
glow	g l ow #1
glowed	g l ow d
glue	g l uw #1
glued	g l uw d
gluttons	g l ah t n z
go	g ow #1
go-cart	g ow k aa r t
goal	g ow l #1
goals	g ow l z
goat	g ow t
goes	g ow z
goin'	g ow ih n
going	g ow ih ng
gold	g ow l d
golfing	g aa l f ih ng
gone	g aa n
gonna	g ah n ah
good	g uh d #1
good-news	g uh d n uw z
good-size	g uh d s ay z
goodness	g uh d n ih s
goodnight	g uh d n ay t
goose	g uw s #1
gooseberry	g uw s b eh r iy
gorgeous	g aa r jh ih s
gosh	g aa sh
got	g aa t
goulash	g uw l aa sh
govern	g ah v er n #1
governing	g ah v er n ih ng
government	g ah v er n m ah n t
governor	g ah v er n er
gowns	g aw n z
grab	g r ae b
gracefully	g r ey s f ah l iy
grade	g r ey d #1
grade-equivalent	g r ey d ih k w ih v l ah n t
grades	g r ey d z
gradually	g r ae jh uw ah l iy
graduation	g r ae jh uw ey sh ih n
grains	g r ey n z
grandmother	g r ae n d m ah dh er
grants	g r ae n t s
graph	g r ae f
grateful	g r ey t f l
graying	g r ey ih ng
grazing	g r ey z ih ng
greasing	g r iy s ih ng
greasy	g r iy s iy
great	g r ey t #1
greater	g r ey t er
greatly	g r ey t l iy
greedily	g r iy d ah l iy
green	g r iy n #1
greenness	g r iy n ih s
greeted	g r iy t ih d
greg	g r eh g #1
gregory	g r eh g er iy
grievance	g r iy v ah n s #1
grievances	g r iy v ah n s ih z
grill	g r ih l
grin	g r ih n #1
grinned	g r ih n d
grip	g r ih p
groin	g r oy n
groom	g r uw m
gross	g r ow s
grotesque	g r ow t eh s k
ground	g r aw n d #1
groundhog	g r aw n d hh aa g
group	g r uw p #1
groups	g r uw p s
grow	g r ow #1
growing	g r ow ih ng
grown	g r ow n #1
grownups	g r ow n ah p s
grows	g r ow z
growth	g r ow th
grudgingly	g r ah jh ih ng l iy
grunt	g r ah n t
guaranteed	g ae r ah n t iy d
guarantees	g ae r ah n t iy z
guard	g aa r d #1
guerrilla	g er ih l ah #1
guerrillas	g er ih l ah z
guess	g eh s
guidance	g ay d n s
guide	g ay d #1
guidebook	g ay d b uh k
guides	g ay d z
guilt	g ih l t #1
guilty	g ih l t iy
gum	g ah m #1
gums	g ah m z
gun	g ah n #1
gunman	g ah n m ih n
gunpoint	g ah n p oy n t
gunpowder	g ah n p aw d er
guns	g ah n z
gurgle	g er g l
gus	g ah s
gushed	g ah sh t
guttural	g ah t er l
guy	g ay #1
guys	g ay z
gwen	g w eh n
gyro	jh ay r ow #1
gyrocompass	jh ay r ow k ah m p ah s
ha	hh aa #1
habit	hh ae b ih t
had	hh ae d
hafta	hh ae f t ah
haggard	hh ae g er d
hails	hh ey l z
hair	hh ae r #1
haired	hh ae r d
half	hh ae f #1
half-city	hh ae f s ih t iy
half-inch	hh ae f ih n ch
half-man	hh ae f m ae n
halloween	hh ae l ow iy n
hallway	hh aa l w ey
halves	hh ae v z
ham	hh ae m #1
ham-radio	hh ae m r ey d iy ow
hand	hh ae n d #1
handbag	hh ae n d b ae g
handed	hh ae n d ih d
handful	hh ae n d f uh l
handle	hh ae n d l #1
handling	hh ae n d l ih ng
hands	hh ae n d z
handsome	hh ae n s ah m
handy	hh ae n d iy #1
handyman	hh ae n d iy m ae n #1
handyman-carpenter	hh ae n d iy m ae n k aa r p ah n t er
hanging	hh ae ng ih ng
hangovers	hh ae ng ow v er z
happen	hh ae p ah n #1
happened	hh ae p ah n d
happening	hh ae p ah n ih ng
happier	hh ae p iy er
happily	hh ae p ah l iy
happy	hh ae p iy #1
hard	hh aa r d #1
hardly	hh aa r d l iy
hardy	hh aa r d iy
harmlessly	hh aa r m l ah s l iy
harmonize	hh aa r m ah n ay z
harmony	hh aa r m ah n iy
harms	hh aa r m z
harsh	hh aa r sh
has	hh ae z #1
hastily	hh ey s t ah l iy
hat	hh ae t #1
hate	hh ey t #1
hated	hh ey t ih d
hatred	hh ey t r ih d
hats	hh ae t s
haughty	hh aa t iy
hauling	hh aa l ih ng
haunted	hh aa n t ih d
have	hh ae v #1
haven't	hh ae v n t
having	hh ae v ih ng
hawing	hh aa ih ng
hay	hh ey #1
hazards	hh ae z er d z
haze	hh ey z
he	hh iy #1
he'd	hh iy d
he'll	hh ih l #1
he's	hh iy z
head	hh eh d #1
head-in-the-clouds	hh eh d ih n dh ah k l aw d z
headache	hh eh d ey k #1
headaches	hh eh d ey k s
heading	hh eh d ih ng
headquarters	hh eh d k w aa t er z
heads	hh eh d z
healing	hh iy l ih ng
health	hh eh l th #1
healthful	hh eh l th f uh l
healthier	hh eh l th iy er
healthy	hh eh l th iy #1
heap	hh iy p
hear	hh ih r #1
heard	hh er d #1
heart	hh aa r t #1
heartily	hh aa r t ah l iy
heat	hh iy t #1
heat's	hh iy t s
heater	hh iy t er
heating	hh iy t ih ng
heave	hh iy v
heaven	hh eh v ah n #1
heavens	hh eh v ah n z
heavier	hh eh v iy er
heavy	hh eh v iy #1
heck	hh eh k
heels	hh iy l z
heights	hh ay t s
held	hh eh l d
helium	hh iy l iy ah m
hell	hh eh l #1
hello	hh eh l ow
help	hh eh l p #1
helpful	hh eh l p f uh l
helping	hh eh l p ih ng
helpless	hh eh l p l ah s
helps	hh eh l p s
hem	hh eh m #1
hemorrhage	hh eh m er ih jh
hen	hh eh n #1
henceforth	hh eh n s f aa r th
henry	hh eh n r iy
hepatitis	hh eh p ah t ay t ih s
her	hh er #1
herb's	hh er b z
herd	hh er d #2
herdin'	hh er d n
here	hh ih r #2
here's	hh ih r z
heritage	hh eh r ah t ih jh
hero	hh ih r ow #1
heroes	hh ih r ow z
heroic	hh ih r ow ih k
heroism	hh eh r ow ih z m
herself	hh er s eh l f
hesitate	hh eh z ih t ey t
hey	hh ey #2
hibachi	hh ih b aa ch iy
hide	hh ay d #1
hides	hh ay d z
hiding	hh ay d ih ng
hierarchies	hh ay er aa r k iy z
high	hh ay #1
higher	hh ay er #1
highest	hh ay ih s t
highly	hh ay l iy
highway	hh ay w ey
hiking	hh ay k ih ng
hills	hh ih l z
hillside	hh ih l s ay d
him	hh ih m #1
himself	hh ih m s eh l f
hindu	hh ih n d uw
hint	hh ih n t
hire	hh ay er #2
hired	hh ay er d
hires	hh ay er z
hiring	hh ay er ih ng
his	hh ih z
hispanic	hh ih s p ae n ih k
historians	hh ih s t aa r iy ah n z
historical	hh ih s t aa r ih k l #1
historically	hh ih s t aa r ih k l iy
history	hh ih s t er iy
hit	hh ih t
hoarse	hh aa r s #1
hold	hh ow l d #1
holder	hh ow l d er
holding	hh ow l d ih ng
holds	hh ow l d z
hole	hh ow l #1
holes	hh ow l z
holiday	hh aa l ih d ey #1
holidays	hh aa l ih d ey z
home	hh ow m #1
home-made	hh ow m ey d
homes	hh ow m z
homogeneous	hh ow m ah jh iy n iy ah s
honest	aa n ih s t #1
honesty	aa n ih s t iy
honey	hh ah n iy #1
honeybees	hh ah n iy b iy z
honor	aa n er
hood	hh uh d
hoofs	hh uh f s
hook	hh uh k #1
hooking	hh uh k ih ng
hope	hh ow p #1
hoped	hh ow p t
hopeful	hh ow p f uh l
hopeless	hh ow p l ah s
horizon	hh er ay z n
horror	hh aa r er
horse	hh aa r s #2
horseback	hh aa r s b ae k
horseplay	hh aa r s p l ey
horses	hh aa r s ih z
hospitalization	hh aa s p ih t l ah z ey sh ih n
hospitals	hh aa s p ih t l z
host	hh ow s t
hostages	hh aa s t ih jh z
hot	hh aa t #1
hotel	hh ow t eh l #1
hotels	hh ow t eh l z
hour	aw r #1
hours	aw r z
house	hh aw s #1
household	hh aw s hh ow l d #1
householder	hh aw s hh ow l d er
houses	hh aw s ih z
housewives	hh aw s w ay v z
housework	hh aw s w er k
housing	hh aw z ih ng
how	hh aw #1
how's	hh aw z #1
however	hh aw eh v er
hub	hh ah b
huge	hh y uw jh
hugged	hh ah g d
hugging	hh ah g ih ng
hull	hh ah l
hum	hh ah m
human	hh y uw m ah n #1
humanism	hh y uw m ah n ih z m
humid	hh y uw m ih d #1
humidity	hh y uw m ih d ih t iy
humor	hh y uw m er #1
humorous	hh y uw m er ah s
hundred	hh ah n d r ah d
hung	hh ah ng #1
hungarian	hh ah ng g eh r iy ah n
hunter	hh ah n t er
hurriedly	hh er ih d l iy
hurry	hh er iy
hurt	hh er t #1
hurts	hh er t s
husband	hh ah z b ah n d #1
husband's	hh ah z b ah n d z
husbandry	hh ah z b ah n d r iy
husky	hh ah s k iy
hut	hh ah t
hyacinths	hh ay ah s ih n th s
hyena	hh ay iy n ah
hyenas	hh ay iy n ih z
hypocrites	hh ih p ah k r ih t s
hypothalamic	hh ay p ow th ah l ae m ih k
hypothetical	hh ay p ah th eh t ih k l
hysterical	hh ih s t eh r ih k l
i	ay #2
i'd	ay d #1
i'll	ay l #1
i'm	ay m
i've	ay v #1
ice	ay s #1
ices	ay s ih z
icicles	ay s ih k l z
icy	ay s iy
idea	ay d iy ah #1
ideal	ay d iy l #1
ideally	ay d iy l iy
ideas	ay d iy ah z
identical	ay d eh n t ih k l
identifiable	ay d eh n t ih f ay ah b l
identified	ay d eh n t ih f ay #1
identify	ay d eh n t ih f ay #2
ideological	ay d iy ah l aa jh ih k l
ideology	ay d iy aa l ah jh iy
idiosyncrasies	ih d iy ih s ih ng k r ih s iy z
idiotic	ih d iy aa t ih k #1
idiotically	ih d iy aa t ih k l iy
idly	ay d l iy
idolize	ay d ah l ay z
if	ih f #1
ignore	ih g n aa r #1
ignored	ih g n aa r d
ignores	ih g n aa r z
iguanas	ih g w aa n ih z
ill	ih l #1
illegal	ih l iy g l #1
illegally	ih l iy g l iy
illness	ih l n ih s #1
illnesses	ih l n ih s ih z
illuminated	ih l uw m ih n ey t ih d
illuminating	ih l uw m ih n ey t ih ng
illumined	ih l uw m ih n d
illusions	ih l uw sh ih n z
image	ih m ih jh #1
images	ih m ih jh ih z
imagination	ih m ae jh ih n ey sh ih n
imagine	ih m ae jh ih n #1
imagined	ih m ae jh ih n d
imitate	ih m ah t ey t
immaterial	ih m ah t ih r iy l
immediate	ih m iy d iy ah t #1
immediately	ih m iy d iy ah t l iy
immortal	ih m aa r t l
impact	ih m p ae k t
imperfect	ih m p er f ih k t
impersonal	ih m p er s n l
implausibly	ih m p l aa z ah b l iy
implications	ih m p l ah k ey sh ih n z
implied	ih m p l ay d
import	ih m p aa r t #1
importance	ih m p aa r t n s
important	ih m p aa r t ah n t
imports	ih m p aa r t s
imposes	ih m p ow z ih z
impossible	ih m p aa s ih b l
impressions	ih m p r eh sh ih n z
improved	ih m p r uw v d
improving	ih m p r uw v ih ng
impulses	ih m p ah l s ih z
in	ih n #1
inadequate	ih n ae d ih k w ah t
inadvisable	ih n ah d v ay z ah b l
inanimate	ih n ae n ah m ah t
inarticulate	ih n aa r t ih k y uh l ih t
inaugural	ih n aa g y er l
inch	ih n ch
include	ih n k l uw d #1
included	ih n k l uw d ih d
including	ih n k l uw d ih ng
inclusions	ih n k l uw sh ih n z
income	ih n k ah m #1
incomplete	ih n k ah m p l iy t
incorporated	ih n k aa r p er ey t ih d
increase	ih n k r iy s #1
increased	ih n k r iy s t
increases	ih n k r iy s ih z
increasing	ih n k r iy s ih ng
indeed	ih n d iy d
indefinable	ih n d ih f ay n ah b l
indefinite	ih n d eh f ah n ih t
indemnity	ih n d eh m n ih t iy
independent	ih n d ah p eh n d ih n t
index	ih n d eh k s
indicate	ih n d ih k ey t #1
indicated	ih n d ih k ey t ih d
indicates	ih n d ih k ey t s
indispensable	ih n d ih s p eh n s ah b l
individual	ih n d ah v ih jh uw l #1
individuals	ih n d ah v ih jh uw l z
indulge	ih n d ah l jh
industry	ih n d ah s t r iy
ineffective	ih n ah f eh k t ih v
inertia	ih n er sh ah
inevitable	ih n eh v ah t ah b l
inexact	ih n ih g z ae k t
inexcusable	ih n ih k s k y uw z ah b l
inexhaustible	ih n ih g z aa s t ah b l
infancy	ih n f ah n s iy
infection	ih n f eh k sh ih n
infectious	ih n f eh k sh uw ah s
infective	ih n f eh k t ih v
inferences	ih n f er ah n s ih z
inferiority	ih n f ih r iy aa r ah t iy
infidels	ih n f ih d l z
infield	ih n f iy l d
infiltration	ih n f ih l t r ey sh ih n
inflammatory	ih n f l ae m ah t aa r iy
inflated	ih n f l ey t ih d
influences	ih n f l uw ah n s ih z
information	ih n f er m ey sh ih n
informative	ih n f aa r m ah t ih v
informed	ih n f aa r m d
infrequent	ih n f r iy k w ah n t
infuriation	ih n f y uh r iy ey sh ih n
ingenuity	ih n jh ih n uw ih t iy
ingredient	ih n g r iy d iy ah n t #1
ingredients	ih n g r iy d iy ah n t s
inhabit	ih n hh ae b ah t
inherited	ih n hh eh r ah t ih d
inhibit	ih n hh ih b ah t
inhibitor	ih n hh ih b ih t er
inhuman	ih n hh y uw m ah n
initiative	ih n ih sh ih t ih v
injected	ih n jh eh k t ih d
injection	ih n jh eh k sh ih n #1
injection-molded	ih n jh eh k sh ih n m ow l d ih d
injuries	ih n jh er iy z
innocence	ih n ih s ih n s
inquired	ih n k w ay er d
inquiry	ih n k w ay er iy
insecticide	ih n s eh k t ih s ay d #1
insecticides	ih n s eh k t ih s ay d z
insert	ih n s er t
inside	ih n s ay d
insist	ih n s ih s t
inspiring	ih n s p ay er ih ng
instability	ih n s t ah b ih l ih t iy
installations	ih n s t ah l ey sh ih n z
installed	ih n s t aa l d
instance	ih n s t ah n s
instant	ih n s t ah n t #1
instantaneous	ih n s t ah n t ey n iy ah s
instead	ih n s t eh d
instinct	ih n s t ih ng t
instructions	ih n s t r ah k sh ih n z
instrument	ih n s t r ah m ah n t #1
instruments	ih n s t r ah m ah n t s
insufficient	ih n s ah f ih sh ih n t
insulate	ih n s ah l ey t #1
insulator	ih n s ah l ey t er
insurance	ih n sh uh r ah n s
integrated	ih n t ih g r ey t ih d
integration	ih n t ih g r ey sh ih n
integrity	ih n t eh g r ah t iy
intelligence	ih n t eh l ih jh ih n s
intelligent	ih n t eh l ih jh ih n t
intelligible	ih n t eh l ah jh ih b l
intent	ih n t eh n t
interchangeably	ih n t er ch ey n jh ah b l iy
interest	ih n t r ah s t #1
interested	ih n t r ah s t ih d
interesting	ih n t r ah s t ih ng
interior	ih n t ih r iy er
internal	ih n t er n l
interpretation	ih n t er p r ah t ey sh ih n #1
interpretations	ih n t er p r ah t ey sh ih n z
intervals	ih n t er v l z
interview	ih n t er v y uw #1
interviewee	ih n t er v y uw iy
interweaving	ih n t er w iy v ih ng
intimate	ih n t ah m ah t
into	ih n t uw #1
introduced	ih n t r ah d uw s t
intrusions	ih n t r uw sh ih n z
intuition	ih n t uw ih sh ih n
invade	ih n v ey d
invaluable	ih n v ae l y uh b l
invariably	ih n v ae r iy ah b l iy
inventories	ih n v ah n t aa r iy z
invest	ih n v eh s t #1
investigation	ih n v eh s t ih g ey sh ih n #1
investigations	ih n v eh s t ih g ey sh ih n z
inviolate	ih n v ay l ih t
invitation	ih n v ih t ey sh ih n
invoked	ih n v ow k t
involved	ih n v aa l v d
involves	ih n v aa l v z
involving	ih n v aa l v ih ng
inward	ih n w er d #1
inwardly	ih n w er d l iy
irate	ay r ey t
iris	ay r ih s
irish	ay r ih sh
iron	ay er n #1
iron-poor	ay er n p uh r
ironic	ay r aa n ih k #1
ironically	ay r aa n ih k l iy
ironing	ay er n ih ng
irons	ay er n z
irradiation	ih r ey d iy ey sh ih n
irremediable	ih r ih m iy d iy ah b l
irresponsible	ih r ih s p aa n s ah b l
irritated	ih r ah t ey t ih d
irving's	er v ih ng z
is	ih z #1
isn't	ih z n t
isotopes	ay s ah t ow p s
issue	ih sh uw #1
issued	ih sh uw d
issues	ih sh uw z
it	ih t #1
it'd	ih t uh d
it's	ih t s #1
itching	ih ch ih ng
item	ay t m #1
itemize	ay t ah m ay z
items	ay t m z
its	ih t s #2
itself	ih t s eh l f
ivory	ay v r iy
jabbed	jh ae b d
jackass	jh ae k ae s
jacket	jh ae k ih t
jaded	jh ey d ih d
jagged	jh ae g ih d
jaguars	jh ae g w aa r z
jam	jh ae m
jane	jh ey n
january	jh ae n y uw eh r iy
jar	jh aa r #1
jars	jh aa r z
jaw	jh aa #1
jealousies	jh eh l ah s iy z
jealousy	jh eh l ah s iy #1
jeep	jh iy p
jeff	jh eh f #1
jeff's	jh eh f s
jennifer's	jh eh n ih f er z
jeopardize	jh eh p er d ay z
jerk	jh er k #1
jerky	jh er k iy
jet	jh eh t
jewel	jh uw l #1
jewel-bright	jh uw l b r ay t
jim	jh ih m #1
jim's	jh ih m z
job	jh aa b
jocular	jh aa k y uh l er
john	jh aa n #1
john's	jh aa n z
join	jh oy n #1
joining	jh oy n ih ng
joint	jh oy n t
jokers	jh ow k er z
jokes	jh ow k s
joking	jh ow k ih ng
journal	jh er n l #1
journalese	jh er n ah l iy z
journalist	jh er n l ih s t
joyce	jh oy s
judge	jh ah jh #1
judged	jh ah jh d
juice	jh uw s #1
juicy	jh uw s iy
jump	jh ah m p #1
jumped	jh ah m p t
jungle	jh ah ng g l #1
jungle-like	jh ah ng g l l ay k
junior	jh uw n y er
just	jh ah s t #1
justification	jh ah s t ih f ah k ey sh ih n
kayak	k ay ae k
kayo	k ey ow
keelson	k iy l s ah n
keep	k iy p
kept	k eh p t
kernels	k er n l z
kerosene	k eh r ih s iy n
key	k iy #1
keyed	k iy d
keys	k iy z
kick	k ih k
kid	k ih d #1
kid's	k ih d z #1
kidnappers	k ih d n ae p er z
kids	k ih d z #2
kill	k ih l #1
killed	k ih l d
kin	k ih n #1
kind	k ay n d #1
kinda	k ay n d ah
kindergarten	k ih n d er g aa r t n
kindly	k ay n d l iy
kippers	k ih p er z
kissed	k ih s t
kitchen	k ih ch ih n
knack	n ae k #1
knee	n iy #1
kneeling	n iy l ih ng
knees	n iy z
knew	n uw #1
knick-	n ih k #1
knick-knacks	n ih k n ae k s
knife	n ay f #1
knifelike	n ay f l ay k
knit	n ih t #1
knitted	n ih t ih d
knives	n ay v z
knocked	n aa k t
know	n ow #1
knowed	n ow d
knowing	n ow ih ng #1
knowingly	n ow ih ng l iy
known	n ow n
knows	n ow z #1
labeled	l ey b l d
labor	l ey b er
laboratory	l ae b r ih t aa r iy
lacerate	l ae s er ey t
lack	l ae k #1
lackeys	l ae k iy z
lactating	l ae k t ey t ih ng
lad	l ae d #1
ladder	l ae d er
lady's	l ey d iy z
ladylike	l ey d iy l ay k
lagoon	l ah g uw n
laid	l ey d #1
lake	l ey k
lamb's	l ae m z
lamp	l ae m p #1
lamps	l ae m p s
land	l ae n d #1
land-based	l ae n d b ey s t
landlord	l ae n d l aa r d
landmarks	l ae n d m aa r k s
language	l ae ng g w ih jh
large	l aa r jh #1
largely	l aa r jh l iy
larger	l aa r jh er
larvae	l aa r v iy
lashed	l ae sh t
lashings	l ae sh ih ng z
last	l ae s t
latches	l ae ch ih z
late	l ey t #1
latent	l ey t n t
later	l ey t er
latest	l ey t ih s t
lathe	l ey dh
latitudes	l ae t ih t uw d z
latter	l ae t er
laugh	l ae f #1
laughed	l ae f t
laughing	l ae f ih ng
lavishly	l ae v ih sh l iy
law	l aa #1
lawful	l aa f uh l
laws	l aa z
lawyer	l aa y er #1
lawyers	l aa y er z
lay	l ey #1
lay-up	l ey ah p
layoffs	l ey aa f s
lazy	l ey z iy
lead	l iy d #1
leader	l iy d er #1
leadership	l iy d er sh ih p
leading	l iy d ih ng
leaf	l iy f #1
leaflet	l iy f l ih t
leagues	l iy g z
leap	l iy p
learn	l er n #1
learned	l er n d
least	l iy s t
leather	l eh dh er
leave	l iy v #1
leaves	l iy v z
leaving	l iy v ih ng #1
leavings	l iy v ih ng z
led	l eh d
ledger	l eh jh er
leeway	l iy w ey
left	l eh f t
leg	l eh g #1
legal	l iy g l
legend	l eh jh ih n d
legged	l eh g d
legislation	l eh jh ih s l ey sh ih n
legislative	l eh jh ih s l ey t ih v
legislature	l eh jh ih s l ey ch er
legs	l eh g z
leisure	l iy sh er
lemon	l eh m ah n
length	l eh ng th #1
lengthy	l eh ng th iy
lentils	l eh n t l z
leopards	l eh p er d z
less	l eh s #1
lesson	l eh s n #1
lessons	l eh s n z
lest	l eh s t
let	l eh t #1
let's	l eh t s
letter	l eh t er #1
letters	l eh t er z
level	l eh v l #1
level's	l eh v l z #1
leveling	l eh v l ih ng
levels	l eh v l z #2
lewd	l uw d
liberal	l ih b er l #1
liberal-led	l ih b er l l eh d
liberals	l ih b er l z
library	l ay b r eh r iy
lid	l ih d #1
lids	l ih d z
lie	l ay #1
life	l ay f #1
lifeboats	l ay f b ow t s
lifelong	l ay f l aa ng
lift	l ih f t #1
lifting	l ih f t ih ng
ligament	l ih g ah m ah n t
light	l ay t #1
lightbulbs	l ay t b ah l b z
lighted	l ay t ih d
lighter	l ay t er
lightly	l ay t l iy
lights	l ay t s
like	l ay k #1
liked	l ay k t
likely	l ay k l iy
likes	l ay k s
likewise	l ay k w ay z
lily	l ih l iy
limit	l ih m ih t
limited	l ih m ah t ih d
lincoln	l ih ng k ah n
line	l ay n #1
lines	l ay n z
lion	l ay ih n
lip	l ih p #1
lips	l ih p s
liquid	l ih k w ih d #1
liquids	l ih k w ih d z
liquor	l ih k er
list	l ih s t #1
listed	l ih s t ih d
lists	l ih s t s
literally	l ih t er ah l iy
literary	l ih t er eh r iy
literature	l ih t er ah ch uh r
lithographs	l ih th ah g r ae f s
litter	l ih t er #1
little	l ih t l
lived	l ih v d
lively	l ay v l iy
lives	l ih v z
livestock	l ay v s t aa k
live~adj	l ay v #1
live~v	l ih v #1
living	l ih v ih ng
loaded	l ow d ih d
loads	l ow d z
lobes	l ow b z
local	l ow k l
locate	l ow k ey t
location	l ow k ey sh ih n
lock	l aa k #1
locked	l aa k t
lodge	l aa jh #1
logical	l aa jh ih k l #1
logically	l aa jh ih k l iy
logs	l aa g z
lone	l ow n #1
loneliness	l ow n l iy n ih s
long	l aa ng #1
long-overdue	l aa ng ow v er d uw
long-range	l aa ng r ey n jh
long-term	l aa ng t er m
longed	l aa ng d
longer	l aa ng g er
longitudes	l aa n jh ih t uw d z
look	l uh k #1
looked	l uh k t
looking	l uh k ih ng
looks	l uh k s
looms	l uw m z
loose	l uw s
lori's	l aa r iy z
lose	l uw z
loss	l aa s #1
losses	l aa s ih z
lost	l aa s t
lot	l aa t #1
lotions	l ow sh ih n z
lots	l aa t s
loudest	l aw d ih s t
loudly	l aw d l iy
louse	l aw s
lousiness	l aw z iy n ih s
love	l ah v #1
loved	l ah v d
lovely	l ah v l iy
lovie	l ah v iy
loving	l ah v ih ng
low	l ow #1
lower	l ow er #1
lowered	l ow er d
loyal	l oy l #1
loyalties	l oy l t iy z
luck	l ah k #1
lucky	l ah k iy
lullaby	l ah l ih b ay
lumber	l ah m b er
lunch	l ah n ch #1
lunchroom	l ah n ch r uw m
lungs	l ah ng z
lush	l ah sh
luxurious	l ah g sh uh r iy ah s
luxury	l ah k sh er iy
lying	l ay ih ng
ma'am	m ae m #1
macabre	m ah k aa b r ah
machine	m ah sh iy n #1
machinery	m ah sh iy n er iy
machines	m ah sh iy n z
mad	m ae d #1
made	m ey d #1
madstones	m ae d s t ow n z
magnetic	m ae g n eh t ih k
magnetism	m ae g n ih t ih z m
magnificently	m ae g n ih f ih s ih n t l iy
magnified	m ae g n ih f ay d
magpies	m ae g p ay z
mahogany	m ah hh aa g ih n iy
maids'	m ey d z
mail	m ey l #1
main	m ey n #1
maintain	m ey n t ey n
maintenance	m ey n t ih n ih n s
major	m ey jh er
majority	m ah jh aa r ih t iy
make	m ey k #1
makes	m ey k s
making	m ey k ih ng
maladies	m ae l ah d iy z
malaria	m ah l ae r iy ah
male	m ey l #2
mammals	m ae m l z
man	m ae n #1
man's	m ae n z
manage	m ae n ih jh #1
managed	m ae n ih jh d
management	m ae n ih jh m ah n t
mandates	m ae n d ey t s
mango	m ae ng g ow
manhood	m ae n hh uh d
manifest	m ae n ah f eh s t
manner	m ae n er #1
mannerism	m ae n er ih z m
manners	m ae n er z
manual	m ae n y uw l
manufacturer	m ae n y uw f ae k ch er er #1
manufacturers	m ae n y uw f ae k ch er er z
manure	m ah n uh er
many	m eh n iy #1
many-bodied	m eh n iy b aa d iy d
map	m ae p
mare's	m ae r z
margaret	m aa r g r ah t
marine	m er iy n #1
marine's	m er iy n z
mark	m aa r k #1
marketing	m aa r k ih t ih ng
markets	m aa r k ih t s
marks	m aa r k s #1
marksmanship	m aa r k s m ah n sh ih p
marriage	m ae r ih jh
married	m ae r iy d
marshmallows	m aa r sh m eh l ow z
marvel	m aa r v l #1
marvelously	m aa r v l ah s l iy
mask	m ae s k #1
masks	m ae s k s
masonry	m ey s n r iy
masquerade	m ae s k er ey d
mass	m ae s #1
massage	m ah s aa sh
massive	m ae s ih v
master	m ae s t er #1
master's	m ae s t er z
masterful	m ae s t er f uh l
matched	m ae ch t
matching	m ae ch ih ng
mate	m ey t #1
material	m ah t ih r iy l #1
materials	m ah t ih r iy l z
mates	m ey t s
mathematics	m ae th ah m ae t ih k s
mathews	m ae th y uw z
matter	m ae t er #1
matters	m ae t er z
mattresses	m ae t r ih s ih z
maturity	m ah ch uh r ih t iy
maximal	m ae k s ah m l
maximize	m ae k s ih m ay z
maximum	m ae k s ih m ah m
may	m ey #1
mayan	m ay ah n
maybe	m ey b iy
mayonnaise	m ey ah n ey z
me	m iy #1
meadow	m eh d ow
meals	m iy l z
mealynosed	m iy l iy n ow z d
mean	m iy n #1
meaning	m iy n ih ng #1
meaningful	m iy n ih ng f uh l
meanness	m iy n ih s
means	m iy n z
meant	m eh n t #1
meanwhile	m iy n hh w ay l
measure	m eh sh er #1
measured	m eh sh er d
measurement	m eh sh er m ah n t
meat	m iy t #1
meats	m iy t s
mechanic	m ih k ae n ih k #1
mechanical	m ih k ae n ih k l
mechanism	m eh k ah n ih z m
media	m iy d iy ah #1
median	m iy d iy ah n
medical	m eh d ih k l
medicine	m eh d ih s ih n
medieval	m iy d ih iy v l
mediocrity	m iy d iy aa k r ih t iy
meet	m iy t #2
meeting	m iy t ih ng #1
meetings	m iy t ih ng z
melancholy	m eh l ih n k aa l iy
melodramatic	m eh l ow d r ah m ae t ih k
melody	m eh l ah d iy
melted	m eh l t ih d
member	m eh m b er #1
members	m eh m b er z
membership	m eh m b er sh ih p
memo	m eh m ow
memorized	m eh m er ay z d
memory	m eh m er iy
men	m eh n #1
mental	m eh n t l
mentality	m eh n t ae l ih t iy
mention	m eh n sh ih n
meow	m iy aw
mercenary	m er s n eh r iy
merchandising	m er ch ih n d ay z ih ng
mercilessly	m er s l eh s l iy
mere	m ih r #1
merely	m ih r l iy
merger	m er jh er #1
mergers	m er jh er z
merit	m eh r ih t
merrily	m eh r ih l iy
mess	m eh s #1
message	m eh s ih jh
messy	m eh s iy
met	m eh t #1
metal	m eh t l #1
metallic	m ah t ae l ih k
method	m eh th ah d #1
methods	m eh th ah d z
mettle	m eh t l #2
miami	m ay ae m iy
michael	m ay k l
micrometeorite	m ay k r ow m iy t iy er ay t #1
micrometeorites	m ay k r ow m iy t iy er ay t s
microorganisms	m ay k r ow aa r g ih n ih z m z
microscopically	m ay k r ih s k aa p ih k l iy
midair	m ih d ae r
midnight	m ih d n ay t
might	m ay t #1
mighty	m ay t iy
mike	m ay k #1
mile	m ay l #1
miles	m ay l z
military	m ih l ih t eh r iy
milk	m ih l k
millionaires	m ih l y ah n ae r z
mind	m ay n d #1
minded	m ay n d ih d
minds	m ay n d z
mine	m ay n #1
mining	m ay n ih ng
minister	m ih n ih s t er
minor	m ay n er
minority	m ay n aa r ah t iy
minute	m ih n ih t #1
minutes	m ih n ih t s
miraculous	m er ae k y uh l ah s #1
miraculously	m er ae k y uh l ah s l iy
mirage	m er aa sh
mirror	m ih r er #1
mirrors	m ih r er z
misbehavior	m ih s b ih hh ey v y er
miserable	m ih z er ah b l
misery	m ih z er iy
mishap	m ih s hh ae p
misinterpret	m ih s n t er p r ah t
misleading	m ih s l iy d ih ng
misperceives	m ih s p er s iy v z
misplaced	m ih s p l ey s t
misprint	m ih s p r ih n t
misquote	m ih s k w ow t
miss	m ih s #1
mistaken	m ih s t ey k ih n
mixed	m ih k s t
mixing	m ih k s ih ng
mobile	m ow b l
mock	m aa k
moded	m ow d ih d
modeled	m aa d l d
modeling	m aa d l ih ng
models	m aa d l z
modern	m aa d er n #1
modernization	m aa d er n ih z ey sh ih n
modernizing	m aa d er n ay z ih ng
modest	m aa d ih s t #1
modesty	m aa d ih s t iy
modified	m aa d ih f ay d
modular	m aa jh uh l er
moist	m oy s t
moistened	m oy s n d
moisture	m oy s ch er
mold	m ow l d #1
molded	m ow l d ih d
mollusks	m aa l ah s k s
mom	m aa m #1
moment	m ow m ah n t #1
momentary	m ow m ah n t eh r iy
moments	m ow m ah n t s
momma	m aa m ah
monday	m ah n d ey
money	m ah n iy
monitored	m aa n ih t er d
monkey	m ah ng k iy #1
monkey-gland	m ah ng k iy g l ae n d
monopolize	m ah n aa p ah l ay z
monstrous	m aa n s t r ah s
month	m ah n th #1
months	m ah n th s
moon	m uw n #1
moonlight	m uw n l ay t
mopped	m aa p t
moral	m aa r l
morale	m er ae l
more	m aa r #1
moreover	m aa r ow v er
morgue	m aa r g #1
morning	m aa r n ih ng
morphological	m aa r f ah l aa jh ih k l
morphophonemic	m aa r f ow f ow n iy m ih k
morrow	m aa r ow #1
mosquitoes	m ah s k iy t ow z
moss	m aa s
most	m ow s t #1
mostly	m ow s t l iy
motel	m ow t eh l
moth	m aa th
mother	m ah dh er #1
mother's	m ah dh er z #1
mothers	m ah dh er z #2
mothers-in-law	m ah dh er z ih n l aa
motioning	m ow sh ih n ih ng
motivates	m ow t ih v ey t s
motor	m ow t er #1
motorists	m ow t er ih s t s #1
motorists'	m ow t er ih s t s #2
mount	m aw n t #1
mountain	m aw n t n #1
mountainside	m aw n t n s ay d
mounting	m aw n t ih ng
mournfully	m aa r n f uh l iy
mouse	m aw s
mouth	m aw th #1
mouthful	m aw th f uh l
move	m uw v #1
moved	m uw v d
movement	m uw v m ah n t
moves	m uw v z
movie	m uw v iy #1
movies	m uw v iy z
moving	m uw v ih ng
mr.	m ih s t er #1
mrs.	m ih s ih z
much	m ah ch #1
mucus	m y uw k ih s
muddleheaded	m ah d l hh eh d ih d
muddy	m ah d iy
mudwagon	m ah d w ae g ah n
muffled	m ah f l d
mugs	m ah g z
multiple	m ah l t ah p l
murals	m y uh r l z
murder	m er d er #1
murderer	m er d er er
murky	m er k iy
murmured	m er m er d
muscle	m ah s l #1
muscles	m ah s l z
muscular	m ah s k y uh l er
museum	m y uw z iy ah m #1
museums	m y uw z iy ah m z
music	m y uw z ih k
musical	m uw z ih k l
musicians	m y uw z ih sh ih n z
muskrat	m ah s k r ae t
must	m ah s t #1
mustache	m ah s t ae sh
mustard	m ah s t er d
mutineer	m y uw t n ih r
my	m ay #1
myopia	m ay ow p iy ah
myself	m ay s eh l f
mysterious	m ih s t ih r iy ah s
mystery	m ih s t er iy
nagging	n ae g ih ng
nailed	n ey l d
nails	n ey l z
naive	n aa iy v
naked	n ey k ih d
name	n ey m #1
named	n ey m d
names	n ey m z
nan's	n ae n z
nancy's	n ae n aa iy z
narrow	n ae r ow #1
narrower	n ae r ow er
nasty	n ae s t iy
nathan	n ey th ih n
national	n ae sh ih n l
natural	n ae ch er l
naturally	n ae ch er ah l iy
nature	n ey ch er
navigate	n ae v ah g ey t
near	n ih r #1
near-at-hand	n ih r ae t hh ae n d
nearby	n ih r b ay
nearer	n ih r er
nearest	n ih r ih s t
nearing	n ih r ih ng
nearly	n ih r l iy
neat	n iy t
necessarily	n eh s ih s eh r ah l iy
necessary	n eh s ih s eh r iy
necessitates	n ih s eh s ah t ey t s
necessity	n ih s eh s ih t iy
neck	n eh k #1
necklace	n eh k l ah s
nectar	n eh k t er
need	n iy d #1
needed	n iy d ih d
needle	n iy d l #1
needle-sharp	n iy d l sh aa r p
needlepoint	n iy d l p oy n t
needless	n iy d l ah s
needs	n iy d z
neglect	n ah g l eh k t
negligent	n eh g l ih jh ih n t
negligible	n eh g l ih jh ih b l
negotiations	n ih g ow sh iy ey sh ih n z
neither	n iy dh er
neoclassic	n iy ow k l ae s ih k
nerves	n er v z
nested	n eh s t ih d
nevada	n ah v ae d ah #1
nevada's	n ah v ae d ah z
never	n eh v er #1
nevertheless	n eh v er dh ah l eh s
new	n uw #2
news	n uw z #1
newspaper	n uw z p ey p er
next	n eh k s t
nice	n ay s #1
nicely	n ay s l iy
night	n ay t #1
nightly	n ay t l iy
nightmares	n ay t m ae r z
nights	n ay t s
nihilistic	n ay ih l ih s t ih k
nine	n ay n
nip	n ih p
no	n ow #2
nobody	n ow b ah d iy #1
nobody's	n ow b ah d iy z
nodded	n aa d ih d
noise	n oy z #1
noisy	n oy z iy
non-	n aa n #1
non-contributory	n aa n k ah n t r ih b y uw t aa r iy
non-nonsense	n aa n aa n s eh n s
non-supervisory	n aa n s uw p er v ay z er iy
none	n ah n
nonprofit	n aa n p r aa f ah t
nonsense	n aa n s eh n s
nonsystematic	n aa n s ih s t ah m ae t ih k
nor	n aa r #1
nora	n aa r ah #1
nora's	n aa r ah z
normal	n aa r m l #1
normally	n aa r m l iy
norms	n aa r m z
north	n aa r th #1
northeast	n aa r th iy s t
northern	n aa r dh er n #1
northerners	n aa r dh er n er z
norwegian	n aa r w iy jh ih n
nose	n ow z #2
not	n aa t
note	n ow t #1
noted	n ow t ih d
notes	n ow t s
noteworthy	n ow t w er dh iy
nothin	n ah th ih n
nothing	n ah th ih ng
notice	n ow t ih s #1
notices	n ow t ih s ih z
notoriety	n ow t er ay ah t iy
novel	n aa v l #1
novelists	n aa v l ih s t s
novelty	n aa v l t iy
now	n aw #1
nowadays	n aw ah d ey z
nowhere	n ow hh w ae r
nuclear	n uw k l iy er
nucleus	n uw k l iy ah s
numb	n ah m #1
number	n ah m b er #1
numbering	n ah m b er ih ng
numbness	n ah m n ih s
numerous	n uw m er ah s
nurses'	n er s ih z
nut	n ah t #1
nutrients	n uw t r iy ah n t s
nutrition	n uw t r ih sh ih n
nuts	n ah t s
nymphomaniacs	n ih m f ah m ey n iy ae k s
o'	ow #1
o'clock	ah k l aa k
oak	ow k #1
oasis	ow ey s ih s
oatmeal	ow t m iy l
oats	ow t s
obey	ow b ey #1
obeying	ow b ey ih ng
objective	ah b jh eh k t ih v #1
objectives	ah b jh eh k t ih v z
object~n	aa b jh eh k t #1
object~v	ah b jh eh k t #1
objects	aa b jh eh k t s
observance	ah b z er v ih n s
observe	ah b z er v #1
observers	ah b z er v er z
obsession	aa b s eh sh ih n #1
obsessions	aa b s eh sh ih n z
obsolescent	aa b s ah l eh s n t
obstacles	aa b s t ih k l z
obtain	ah b t ey n #1
obtained	ah b t ey n d
obtaining	ah b t ey n ih ng
obverse	ah b v er s
obvious	aa b v iy ah s #1
obviously	aa b v iy ah s l iy
occasionally	ah k ey sh ih n ah l iy
occupied	aa k y uw p ay d
occur	ah k er #1
occurred	ah k er d
occurs	ah k er z
ocean	ow sh ih n #1
ocean's	ow sh ih n z
oceanographic	ow sh ih n ah g r ae f ih k
octillion	aa k t ih l y ah n
odd	aa d #1
odds	aa d z #1
odds-on	aa d z aa n
odor	ow d er
of	ah v #1
off	aa f #1
off-duty	aa f d uw t iy
offensive	ah f eh n s ih v
offer	aa f er #1
offered	aa f er d
offering	aa f er ih ng
office	aa f ah s #1
officer	aa f ah s er #1
officers	aa f ah s er z
offices	aa f ah s ih z
official	ah f ih sh l #1
officials	ah f ih sh l z
often	aa f ah n
ogress	ow g r eh s
oh	ow #2
oil	oy l #1
oil-field	oy l f iy l d
oils	oy l z
oily	oy l iy
ointment	oy n t m ah n t
okay	ow k ey
old	ow l d #1
old-timers	ow l d t ay m er z
older	ow l d er
oldsters	ow l d s t er z
ole	ow l #1
olive	aa l ih v
omitted	ow m ih t ih d
omitting	ow m ih t ih ng
on	aa n #1
once	w ah n s
one	w ah n #1
one's	w ah n z #1
one-half	w ah n hh ae f
one-o'clock	w ah n ah k l aa k
one-upmanship	w ah n ah p m ah n sh ih p
ones	w ah n z #2
onion	ah n y ah n
only	ow n l iy
onto	aa n t uw
oozed	uw z d
opaque	ow p ey k
open	ow p ah n #1
opened	ow p ah n d
opening	ow p ah n ih ng
opens	ow p ah n z
opera	aa p er ah
operated	aa p er ey t ih d
operates	aa p er ey t s
operation	aa p er ey sh ih n
opinions	ah p ih n y ah n z
opium	ow p iy ah m
opportunity	aa p er t uw n ih t iy
opposing	ah p ow z ih ng
opposite	aa p ah z ih t
oppressive	ah p r eh s ih v
optical	aa p t ih k l
optimal	aa p t ah m l
optimism	aa p t ah m ih z m
or	aa r #2
orange	aa r ih n jh
oratorical	aa r ah t aa r ih k l
orchestra	aa r k ih s t r ah
order	aa r d er #1
ordering	aa r d er ih ng
orders	aa r d er z
organism	aa r g ih n ih z m
organist	aa r g ih n ih s t
organizations	aa r g ih n ih z ey sh ih n z
oriental	aa r iy eh n t l
oriented	aa r iy eh n t ih d
origin	aa r ih jh ih n #1
original	aa r ih jh ih n l #1
originally	aa r ih jh ih n ah l iy
originals	aa r ih jh ih n l z
orthodontic	aa r th ah d aa n t ih k
orthodontist	aa r th ah d aa n t ih s t
other	ah dh er #1
others	ah dh er z
otherwise	ah dh er w ay z
otto's	aa t ow z
ought	aa t #1
our	aw r #2
ourselves	aw r s eh l v z
out	aw t #1
out-moded	aw t m ow d ih d
out-of-doors	aw t ah v d aa r z
outage	aw t ih jh
outcast	aw t k ae s t
outcome	aw t k ah m
outdoors	aw t d aa r z
outer	aw t er
outfielders	aw t f iy l d er z
outfit	aw t f ih t
outgrew	aw t g r uw
outgrow	aw t g r ow
outlaws	aw t l aa z
outlook	aw t l uh k
outpost	aw t p ow s t
outputs	aw t p uh t s
outset	aw t s eh t
outside	aw t s ay d
outstanding	aw t s t ae n d ih ng
outward	aw t w er d
oval	ow v l
over	ow v er #1
overalls	ow v er aa l z
overboard	ow v er b aa r d
overcame	ow v er k ey m
overcharged	ow v er ch aa r jh d
overdue	ow v er d uw
overeating	ow v er iy t ih ng
overflowed	ow v er f l ow d
overhangs	ow v er hh ae ng z
overhead	ow v er hh eh d
overlap	ow v er l ae p #1
overlapping	ow v er l ae p ih ng
overloaded	ow v er l ow d ih d
overlooked	ow v er l uh k t
overly	ow v er l iy
overnight	ow v er n ay t #1
overnighters	ow v er n ay t er z
overplayed	ow v er p l ey d
overprotection	ow v er p r ah t eh k sh ih n
overriding	ow v er r ay d ih ng
oversized	ow v er s ay z d
overtake	ow v er t ey k
overthrow	ow v er th r ow
overweight	ow v er w ey t
overwhelm	ow v er w eh l m #1
overwhelmed	ow v er w eh l m d
overwritten	ow v er r ih t n
own	ow n #1
owner	ow n er
owns	ow n z
oyster	oy s t er #1
oysters	oy s t er z
pa	p aa #1
pace	p ey s #1
pack	p ae k #1
package	p ae k ih jh
packing	p ae k ih ng
padlock	p ae d l aa k
paid	p ey d
pail	p ey l #1
pain	p ey n #1
paintings	p ey n t ih ng z
pair	p ae r #1
pairs	p ae r z
pale	p ey l #2
palm	p aa m #1
palpably	p ae l p ah b l iy
pam	p ae m #1
pamphlets	p ae m f l ih t s
pan	p ae n #1
panelization	p ae n l ay z ey sh ih n
panic	p ae n ih k
pansies	p ae n z iy z
papaya	p ah p ay ah
paper	p ey p er #1
papered	p ey p er d
paperweight	p ey p er w ey t
paprika	p ae p r iy k ah
parades	p er ey d z
paragraph	p ae r ah g r ae f
parallel	p ae r ah l eh l
paralysis	p er ae l ih s ih s
paramagnetic	p ae r ah m ae g n eh t ih k
paranoid	p ae r ah n oy d
pardon	p aa r d ih n
parental	p er eh n t l
parenthood	p ae r ah n t hh uh d
park	p aa r k #1
parking	p aa r k ih ng
parrots	p ae r ah t s
part	p aa r t #1
part-time	p aa r t ay m
parted	p aa r t ih d
participant	p aa r t ih s ah p ah n t #1
participants	p aa r t ih s ah p ah n t s
participate	p aa r t ih s ah p ey t #1
participates	p aa r t ih s ah p ey t s
particular	p er t ih k y uh l er #1
particularly	p er t ih k y uh l er l iy
parties	p aa r t iy z
partly	p aa r t l iy
partner	p aa r t n er
parts	p aa r t s
pass	p ae s #1
passed	p ae s t #1
passing	p ae s ih ng
passions	p ae sh ih n z
passive	p ae s ih v
past	p ae s t #2
paste	p ey s t
pastime	p ae s t ay m
pasture	p ae s ch er
path	p ae th #1
pathetic	p ah th eh t ih k
pathological	p ae th ah l aa jh ih k l
patient	p ey sh ih n t #1
patient's	p ey sh ih n t s
patiently	p ey sh ih n t l iy
patrons	p ey t r ah n z
patsy	p ae t s iy
pattered	p ae t er d
pattern	p ae t er n #1
patterns	p ae t er n z
pause	p aa z #1
paused	p aa z d
paw	p aa #2
pay	p ey #1
payments	p ey m ah n t s
pays	p ey z
peace	p iy s #1
peacefully	p iy s f uh l iy
peach	p iy ch #1
peaches	p iy ch ih z
peanut	p iy n ah t
pearls	p er l z
peas	p iy z
peck	p eh k
peculiar	p ah k y uw l y er
pedestal	p eh d ih s t l
peeling	p iy l ih ng
peered	p ih r d
penalty	p eh n l t iy
pendulum	p eh n jh ah l ah m
penetrated	p eh n ih t r ey t ih d
penguins	p eh ng g w ah n z
penicillin	p eh n ih s ih l ih n
pension	p eh n sh ih n
people	p iy p l
pepper	p eh p er #1
peppered	p eh p er d
per	p er #1
per-year	p er y ih r
perception	p er s eh p sh ih n
perennial	p er eh n iy l
perfect	p er f eh k t #1
perfectly	p er f eh k t l iy
performance	p er f aa r m ah n s #1
performances	p er f aa r m ah n s ih z
performers	p er f aa r m er z
perfume	p er f y uw m
perhaps	p er hh ae p s
perils	p eh r l z
period	p ih r iy ih d #1
periodical	p ih r iy aa d ih k l #1
periodically	p ih r iy aa d ih k l iy
periods	p ih r iy ih d z
permanent	p er m ah n ih n t
permit	p er m ih t
perpendicular	p er p ih n d ih k y uh l er
persistently	p er s ih s t ih n t l iy
persisting	p er s ih s t ih ng
person	p er s ih n #1
personal	p er s ih n l
personality	p er s ih n ae l ih t iy
personalized	p er s ih n ah l ay z d
personnel	p er s ih n eh l
persons	p er s ih n z
persuaded	p er s w ey d ih d
persuasively	p er s w ey s ih v l iy
pert	p er t #1
pertinent	p er t n ih n t
pervasive	p er v ey s ih v
perverse	p er v er s
pessimism	p eh s ah m ih z m
pests	p eh s t s
petticoats	p eh t ih k ow t s
petting	p eh t ih ng
petty	p eh t iy
pewter	p y uw t er
phase	f ey z
phenomenon	f ih n aa m ah n aa n
phil's	f ih l z
phone	f ow n #1
phones	f ow n z
phony	f ow n iy
phosphate	f aa s f ey t #1
phosphates	f aa s f ey t s
photochemical	f ow t ah k eh m ih k l
photographs	f ow t ow g r ae f s
photos	f ow t ow z
phrase	f r ey z
physical	f ih z ih k l
piano	p iy ae n ow
pick	p ih k #1
picked	p ih k t
picket	p ih k ih t
pickpocket	p ih k p aa k ih t #1
pickpockets	p ih k p aa k ih t s
picture	p ih k ch er #1
pictures	p ih k ch er z
pie	p ay #1
piece	p iy s #2
piecemeal	p iy s m iy l
pieces	p iy s ih z
pig	p ih g
pigeons	p ih jh ih n z
pile	p ay l #1
piled	p ay l d
pilgrims	p ih l g r ah m z
pill	p ih l #1
pills	p ih l z
pilots	p ay l ah t s #1
pilots'	p ay l ah t s #2
pine	p ay n #1
pink	p ih ng k
pins	p ih n z
pint	p ay n t #1
pint-sized	p ay n t s ay z d
pinto	p ih n t ow
pioneer	p ay ah n ih r
piped	p ay p t
pistachio	p ah s t ae sh iy ow
pit	p ih t #1
pitch	p ih ch #1
pitched	p ih ch t
pitcher	p ih ch er
pitiable	p ih t iy ah b l
pity	p ih t iy #1
pizzerias	p iy t s er iy ah z
place	p l ey s #1
placed	p l ey s t
places	p l ey s ih z
plaintiff	p l ey n t ih f
plan	p l ae n #1
plane	p l ey n #1
planes	p l ey n z
planets	p l ae n ih t s
planned	p l ae n d
planning	p l ae n ih ng
plans	p l ae n z
plant	p l ae n t #1
planted	p l ae n t ih d
plasters	p l ae s t er z
plate	p l ey t #1
plated	p l ey t ih d
platform	p l ae t f aa r m
play	p l ey #1
played	p l ey d
player	p l ey er #1
players	p l ey er z
playin'	p l ey n #2
plays	p l ey z
pleasant	p l eh z n t #1
pleasantly	p l eh z n t l iy
please	p l iy z
pleasure	p l eh sh er
pledge	p l eh jh
plenty	p l eh n t iy
plow	p l aw
plumber	p l ah m er
plunged	p l ah n jh d
plymouth	p l ih m ih th
plywood	p l ay w uh d
pneumonia	n uh m ow n y ah
poach	p ow ch
pocket	p aa k ih t #1
pockets	p aa k ih t s
poems	p ow ah m z
poetry	p ow ah t r iy
poets	p ow ah t s
poignancy	p oy n y ah n t s iy
point	p oy n t #1
pointing	p oy n t ih ng
points	p oy n t s
poised	p oy z d
poison	p oy z n #1
poisoned	p oy z n d
poisonous	p oy z ih n ih s
poisons	p oy z n z
policeman	p ah l iy s m ae n
policy	p aa l ih s iy
polished	p aa l ih sh t
politeness	p ah l ay t n ih s
political	p ah l ih t ih k l
politics	p aa l ih t ih k s
polyesters	p aa l iy eh s t er z
pompousness	p aa m p ah s n ih s
pond	p aa n d
pool	p uw l #1
pool-side	p uw l s ay d
pools	p uw l z
poor	p uh r #1
poorly	p uh r l iy
pop	p aa p #1
populace	p aa p y uh l ah s
popular	p aa p y uh l er
popularity	p aa p y uh l ae r ah t iy
population	p aa p y uh l ey sh ih n
porch	p aa r ch
porcupines	p aa r k y uw p ay n z
pork	p aa r k #2
portable	p aa r t ah b l
portion	p aa r sh ih n
portray	p aa r t r ey #1
portrayal	p aa r t r ey l
position	p ah z ih sh ih n
positive	p aa z ih t ih v
possessed	p ah z eh s t
possibilities	p aa s ih b ih l ih t iy z
possibility	p aa s ih b ih l ih t iy #1
possible	p aa s ih b l
post	p ow s t #1
post-attack	p ow s t ah t ae k
postdate	p ow s t d ey t
postponed	p ow s t p ow n d
potatoes	p ah t ey t ow z
potent	p ow t n t
pottery	p aa t er iy
poultices	p ow l t ih s ih z
poultry	p ow l t r iy
pound	p aw n d
pouring	p aa r ih ng
poverty	p aa v er t iy
powder	p aw d er #1
powders	p aw d er z
power	p aw er #1
powered	p aw er d
powerful	p aw er f uh l #1
powerfully	p aw er f uh l iy
powers	p aw er z
practical	p r ae k t ih k l
practically	p r ae k t ih k ah l iy
practiced	p r ae k t ih s t
practices	p r ae k t ih s ih z
praises	p r ey z ih z
prayed	p r ey d
preached	p r iy ch t
precariously	p r ih k ae r iy ah s l iy
precaution	p r ih k aa sh ih n
preceded	p r iy s iy d ih d
precincts	p r iy s ih ng k t s
precision	p r ih s ih sh ih n
predicament	p r ih d ih k ah m ah n t
predispositions	p r iy d ih s p ah z ih sh ih n z
predominantly	p r ih d aa m ih n ih n t l iy
prefers	p r ih f er z
premiums	p r iy m iy ah m z
preoccupied	p r iy aa k y uw p ay d
preparation	p r eh p er ey sh ih n
prepare	p r ih p ae r #1
prepared	p r ih p ae r d
preparing	p r ih p ae r ih ng
preprepared	p r iy p r ih p ae r d
prerequisite	p r iy r eh k w ah z ih t
preschooler	p r iy s k uw l er
prescribe	p r ih s k r ay b
prescription	p r ih s k r ih p sh ih n
presented	p r ah z eh t ih d
presently	p r eh z n t l iy
present~n~adj	p r eh z n t #1
present~v	p r ih z eh n t #1
presents	p r ih z eh n t s
preservation	p r eh z er v ey sh ih n
preserved	p r ih z er v d
preserves	p r ih z er v z
president	p r eh z ih d ih n t
pressure	p r eh sh er
prestige	p r eh s t iy sh
presumably	p r ih z uw m ah b l iy
presumed	p r ih z uw m d
presumes	p r ih z uw m z
pretend	p r ih t eh n d
pretty	p r ih t iy
prevent	p r ah v eh n t #1
prevented	p r ah v eh n t ih d
preventing	p r ah v eh n t ih ng
previous	p r iy v iy ah s
price	p r ay s #1
prices	p r ay s ih z
primacy	p r ay m ah s iy
primarily	p r ay m eh r ah l iy
primary	p r ay m eh r iy
prime	p r ay m #1
primitive	p r ih m ah t ih v
primly	p r ih m l iy
princes	p r ih n s ih z
principles	p r ih n s ih p l z
print	p r ih n t #1
prints	p r ih n t s
priorities	p r ay aa r ih t iy z
priority	p r ay aa r ih t iy #1
prison	p r ih z n #1
prisoner	p r ih z n er #1
prisoners	p r ih z n er z
private	p r ay v ah t #1
private-eye	p r ay v ah t ay
privately	p r ay v ah t l iy
privations	p r ay v ey sh ih n z
prizes	p r ay z ih z
probabilities	p r aa b ah b ih l ih t iy z
probably	p r aa b ah b l iy
probes	p r ow b z
problem	p r aa b l ah m #1
problems	p r aa b l ah m z
procaine	p r ow k ey n
procedure	p r ah s iy jh er
proceeding	p r ow s iy d ih ng
proceeds	p r ow s iy d z
process	p r aa s eh s #1
processed	p r aa s eh s t
processes	p r aa s eh s ih z
processing	p r aa s eh s ih ng
produce	p r ow d uw s #1
produced	p r ow d uw s t
product	p r aa d ah k t #1
production	p r ah d ah k sh ih n
products	p r aa d ah k t s
profession	p r ah f eh sh ih n #1
professional	p r ah f eh sh ih n l
profit	p r aa f ih t #1
profits	p r aa f ih t s
program	p r ow g r ae m #1
programs	p r ow g r ae m z
progress	p r aa g r eh s
progression	p r ah g r eh sh ih n
projected	p r aa jh eh k t ih d
project~n	p r aa jh eh k t #1
project~v	p r ah jh eh k t
projects	p r aa jh eh k t s
prominent	p r aa m ah n ih n t
promote	p r ah m ow t
prompted	p r aa m p t ih d
promptly	p r aa m p t l iy
pronoun	p r ow n aw n
pronunciation	p r ah n ah n s iy ey sh ih n
proof	p r uw f
proper	p r aa p er #1
properly	p r aa p er l iy
properties	p r aa p er t iy z
property	p r aa p er t iy #1
prophets	p r aa f ah t s
proposed	p r ah p ow z d
propriety	p r ah p r ay ah t iy
props	p r aa p s
prose	p r ow z
prospect	p r aa s p eh k t
prospective	p r ah s p eh k t ih v
protected	p r ah t eh k t ih d
protection	p r ah t eh k sh ih n
protects	p r ah t eh k t s
protein	p r ow t iy n
protests	p r ow t eh s t s
proud	p r aw d
prove	p r uw v #1
proved	p r uw v d
proven	p r uw v ah n
provide	p r ah v ay d #1
provided	p r ah v ay d ih d
provides	p r ah v ay d z
provisions	p r ah v ih sh ih n z
provocatively	p r ah v aa k ih t ih v l iy
provoked	p r ah v ow k t
prowler	p r aw l er
psychiatrist	s ay k ay ah t r ih s t
psychical	s ay k ih k l
psychological	s ay k ah l aa jh ih k l
psychologically	s ay k ah l aa jh ih k ah l iy
psychopath	s ay k ow p ae th
public	p ah b l ih k
publicity	p ah b l ih s ih t iy
published	p ah b l ih sh t
pull	p uh l #1
pulled	p uh l d
pulling	p uh l ih ng
pulsing	p ah l s ih ng
pummeled	p ah m l d
pumped	p ah m p t
pumps	p ah m p s
punch	p ah n ch
puncturing	p ah ng k ch er ih ng
pungent	p ah n jh ih n t
punish	p ah n ih sh #1
punishes	p ah n ih sh ih z
punishment	p ah n ih sh m ah n t
puny	p y uw n iy
puppets	p ah p ah t s
purchase	p er ch ih s #1
purchased	p er ch ih s t
purchasers	p er ch ih s er z
pure	p y uh r #1
puree	p y uh r ey
purists	p y uh r ih s t s
purple	p er p l
purpose	p er p ah s #1
purposeless	p er p ah s l ah s
purposely	p er p ah s l iy
pursed	p er s t
pursued	p er s uw d
pursuing	p er s uw ih ng
push	p uh sh #1
push-ups	p uh sh ah p s
put	p uh t
puzzlement	p ah z l m ah n t
puzzling	p ah z l ih ng
quackery	k w ae k er iy
quality	k w aa l ih t iy
quarrel	k w aa r l #1
quarrels	k w aa r l z
quarter	k w aa r t er #1
quarter-century-old	k w aa r t er s eh n ch er iy ow l d
quarter-inch	k w aa r t er ih n ch
quarters	k w aa r t er z
queen	k w iy n
querulous	k w eh r l ah s
question	k w eh s ch ih n #1
questions	k w eh s ch ih n z
quick	k w ih k #1
quickly	k w ih k l iy
quieted	k w ay ih t ih d
quietly	k w ay ih t l iy
quince	k w ih n s
quite	k w ay t
quote	k w ow t
rabbit	r ae b ih t #1
rabbits	r ae b ih t s
rabies	r ey b iy z
raccoons	r ae k uw n z
race	r ey s #1
rachel's	r ey ch l z
racing	r ey s ih ng
rack	r ae k #1
racy	r ey s iy
radar	r ey d aa r
radiated	r ey d iy ey t ih d
radiation	r ey d iy ey sh ih n
radicalism	r ae d ih k l ih z m
radio	r ey d iy ow #1
radioactive	r ey d iy ow ae k t ih v #1
radioactivity	r ey d iy ow ae k t ih v ah t iy
radiosterilization	r ey d iy ow s t eh r l ay z ey sh ih n
rag	r ae g #1
rags	r ae g z
rail	r ey l #1
railroad	r ey l r ow d
rain	r ey n #1
raindrops	r ey n d r aa p s
rains	r ey n z
raisers	r ey z er z
raisins	r ey z n z
raked	r ey k t
ralph	r ae l f
ramifications	r ae m ah f ah k ey sh ih n z
ran	r ae n #1
ranch	r ae n ch
random	r ae n d ah m
rang	r ae ng
range	r ey n jh
rape	r ey p
rapid	r ae p ih d
rapidly	r ae p ah d l iy
rare	r ae r #1
rarely	r ae r l iy
rasped	r ae s p t
rate	r ey t #1
rated	r ey t ih d
rates	r ey t s
rather	r ae dh er
rating	r ey t ih ng
rationalize	r ae sh ih n l ay z
rationing	r ae sh ih n ih ng
rattled	r ae t l d
rattlesnake	r ae t l s n ey k
raw	r aa #1
ray	r ey #1
reach	r iy ch #1
reached	r iy ch t
reaction	r iy ae k sh ih n
reader	r iy d er
readiness	r eh d ih n ih s
reading	r iy d ih ng
reads	r iy d z
ready	r eh d iy
read~v_past	r eh d #1
read~v_pres	r iy d #1
real	r iy l #1
realism	r iy l ih z m
realistic	r iy l ih s t ih k
reality	r iy ae l ih t iy
realization	r iy l ah z ey sh ih n
realize	r iy l ay z #1
realizing	r iy l ay z ih ng
really	r iy l iy
rearrange	r iy ah r ey n jh
reason	r iy z n #1
reasonable	r iy z n ah b l #1
reasonably	r iy z n ah b l iy
reasons	r iy z n z
reassurance	r iy ah sh uh r ih n s
reassure	r iy ah sh uh r #1
reassuring	r iy ah sh uh r ih ng
recall	r ih k aa l #1
recalled	r ih k aa l d
received	r ih s iy v d
receiving	r ih s iy v ih ng
recent	r iy s n t #1
recently	r iy s n t l iy
receptacle	r ih s eh p t ih k l
reception	r ih s eh p sh ih n
recognition	r eh k ah g n ih sh ih n
recognize	r eh k ah g n ay z #1
recognized	r eh k ah g n ay z d
recoiled	r ih k oy l d
recommendation	r eh k ah m eh n d ey sh ih n
recommended	r eh k ah m eh n d ih d
reconnaissance	r ih k aa n ih z ih n s
reconsider	r iy k ih n s ih d er #1
reconsidered	r iy k ih n s ih d er d
record	r eh k er d #1
records	r eh k er d z
recreation	r eh k r iy ey sh ih n
recriminations	r ah k r ih m ih n ey sh ih n z
rector	r eh k t er
recuperating	r ih k uw p er ey t ih ng
red	r eh d #2
red-handed	r eh d hh ae n d ih d
redcoats	r eh d k ow t s
redecorating	r iy d eh k er ey t ih ng
redeposition	r iy d eh p ah z ih sh ih n
redheads	r eh d hh eh d z
redoubled	r ah d ah b l d
reduced	r ih d uw s t
reducing	r ih d uw s ih ng
reduction	r ih d ah k sh ih n
redwoods	r eh d w uh d z
reference	r eh f er n s
referred	r ih f er d
reflect	r ih f l eh k t #1
reflects	r ih f l eh k t s
reflexes	r iy f l eh k s ih z
reform	r ih f aa r m
refrigerator	r ih f r ih jh er ey t er
refund	r iy f ah n d
refurbishing	r ih f er b ih sh ih ng
refusal	r ih f y uw z l
refuse	r ih f y uw z #1
refused	r ih f y uw z d
regard	r ih g aa r d #1
regarding	r ih g aa r d ih ng
regenerating	r iy jh eh n er ey t ih ng
regret	r ih g r eh t
regular	r eh g y uh l er #1
regulars	r eh g y uh l er z
regulations	r eh g y uh l ey sh ih n z
regulative	r eh g y uh l ah t ih v
rehabilitation	r iy hh ah b ih l ih t ey sh ih n
reinforce	r iy ih n f aa r s
rejected	r ih jh eh k t ih d
related	r ih l ey t ih d
relationship	r ih l ey sh ih n sh ih p
relatively	r eh l ih t ih v l iy
relaxed	r ih l ae k s t
release	r ih l iy s #1
released	r ih l iy s t
relief	r ih l iy f
relieved	r ih l iy v d
relieving	r ih l iy v ih ng
religion	r ih l ih jh ih n
relinquishing	r ih l ih ng k w ih sh ih ng
relish	r eh l ih sh
rely	r ih l ay
remain	r ih m ey n #1
remained	r ih m ey n d
remaining	r ih m ey n ih ng
remains	r ih m ey n z
remember	r ih m eh m b er #1
remembered	r ih m eh m b er d
remembers	r ih m eh m b er z
remembrance	r ih m eh m b r ih n s
reminded	r ih m ay n d ih d
reminds	r ih m ay n d z
reminiscence	r eh m ah n ih s ih n s
remote	r ih m ow t
removal	r ih m uw v l
remove	r ih m uw v #1
rent	r eh n t #1
rented	r eh n t ih d
renunciation	r ih n ah n s iy ey sh ih n
reorganization	r iy aa r g ih n ay z ey sh ih n
repainted	r ih p ey n t ih d
repainting	r ih p ey n t ih ng
repeat	r ih p iy t #1
repeated	r ih p iy t ih d
repetition	r eh p ah t ih sh ih n
replace	r ih p l ey s #1
replaced	r ih p l ey s t
replenish	r ih p l eh n ih sh
replied	r ih p l ay d
reply	r ih p l ay #1
report	r ih p aa r t #1
reported	r ih p aa r t ih d
reporters	r ih p aa r t er z
reportorial	r eh p er t aa r iy l
reports	r ih p aa r t s
represent	r eh p r iy z eh n t #1
representation	r eh p r iy z eh n t ey sh ih n
represented	r eh p r iy z eh n t ih d
represents	r eh p r iy z eh n t s
reproduce	r iy p r ah d uw s
reptiles	r eh p t l z
repugnant	r ih p ah g n ih n t
requests	r ih k w eh s t s
required	r ih k w ay er d
requirements	r ih k w ay er m ah n t s
requires	r ih k w ay er z
rescue	r eh s k y uw
research	r iy s er ch
resemble	r ih z eh m b l
reserved	r ih z er v d
residential	r eh z ih d eh n ch l
resides	r ih z ay d z
residues	r eh z ih d uw z
resin	r eh z ih n #1
resin-saturated	r eh z ih n s ae ch uh r ey t ih d
resistance	r ih z ih s t ih n s
resolute	r eh z ah l uw t
resolution	r eh z ah l uw sh ih n
resolved	r ih z aa l v d
respect	r ih s p eh k t #1
respected	r ih s p eh k t ih d
response	r ih s p aa n s #1
responsibility	r ih s p aa n s ih b ih l ih t iy
responsible	r ih s p aa n s ih b l
responsively	r ih s p aa n s ih v l iy
rest	r eh s t
restricted	r ih s t r ih k t ih d
result	r ih z ah l t #1
resulted	r ih z ah l t ih d
results	r ih z ah l t s
resumed	r ih z uw m d
retaliatory	r ih t ae l ih t aa r iy
retinal	r eh t ih n l
retire	r ih t ay er #1
retired	r ih t ay er d
retirement	r ih t ay er m ah n t
retires	r ih t ay er z
retouching	r ih t ah ch ih ng
retracted	r ih t r ae k t ih d
retribution	r eh t r ah b y uw sh ih n
return	r ih t er n
reupholstering	r ih ah p hh ow l s t er ih ng
revealed	r ih v iy l d
revealing	r ih v iy l ih ng
revenge	r ih v eh n jh
revenues	r eh v ah n uw z
reverberated	r ih v er b er ey t ih d
review	r ih v y uw #1
reviewers	r ih v y uw er z
revised	r ih v ay z d
revolution	r eh v ah l uw sh ih n
revolving	r ih v aa l v ih ng
revulsion	r ih v ah l sh ih n
rewarded	r ih w aa r d ih d
rewrite	r ih r ay t
rhinoceros	r ay n aa s er ah s
rhubarb	r uw b aa r b
rhythm	r ih dh m #1
rhythmically	r ih dh m ih k l iy
ribbons	r ih b ih n z
rice	r ay s
rich	r ih ch #1
rickety	r ih k ih t iy
ride	r ay d #1
rides	r ay d z
ridge	r ih jh #1
ridiculously	r ah d ih k y uh l ah s l iy
riding	r ay d ih ng
rifle	r ay f l #1
rifleman	r ay f l m ah n
right	r ay t #1
rights	r ay t s #1
rim	r ih m #1
ringing	r ih ng ih ng
riot	r ay ah t
ripe	r ay p
ripped	r ih p t
ripping	r ih p ih ng
rise	r ay z #1
rising	r ay z ih ng
risks	r ih s k s
rites	r ay t s #2
ritual	r ih ch uw l #1
rituals	r ih ch uw l z
river	r ih v er #1
riverbank	r ih v er b ae ng k
road	r ow d #1
roadway	r ow d w ey
roam	r ow m #1
roast	r ow s t #1
roasts	r ow s t s
rob	r aa b #1
robin	r aa b ih n
rock	r aa k #1
rock-and-roll	r aa k ae n d r ow l
rockets	r aa k ih t s
rocky	r aa k iy
rode	r ow d #2
rods	r aa d z
roger's	r aa jh er z
role	r ow l #1
roleplaying	r ow l p l ey ih ng
roles	r ow l z #1
roll	r ow l #2
rolled	r ow l d
rolls	r ow l z #2
romance	r ow m ae n s
romantic	r ow m ae n t ih k
ron's	r aa n z
roof	r uw f #1
roofs	r uw f s
rooftree	r uw f t r iy
room	r uw m #1
rooms	r uw m z
root	r uw t #1
rootless	r uw t l ah s
ropes	r ow p s
rose	r ow z #1
roses	r ow z z
rosy	r ow z iy
rough	r ah f #1
rough-tough	r ah f t ah f
roulette's	r uw l eh t s
routine	r uw t iy n #1
routinely	r uw t iy n l iy
rove	r ow v
roy	r oy #1
royal	r oy l
rubbed	r ah b d
rubberized	r ah b er ay z d
rubbish	r ah b ih sh
ruffles	r ah f l z
rug	r ah g #1
rugs	r ah g z
ruins	r uw ih n z
rule	r uw l #1
ruled	r uw l d
rules	r uw l z
rumen	r uw m ah n
run	r ah n #1
run-down	r ah n d aw n
running	r ah n ih ng
runs	r ah n z
rural	r uh r l
rushing	r ah sh ih ng
rust	r ah s t
rustling	r ah s l ih ng
sacrifice	s ae k r ih f ay s
sacrificial	s ae k r ah f ih sh l
saddlebags	s ae d l b ae g z
saddled	s ae d l d
sadness	s ae d n ih s
safari	s ah f aa r iy
safe	s ey f #1
safekeeping	s ey f k iy p ih ng
safer	s ey f er
safety	s ey f t iy
saga	s aa g ah
sagging	s ae g ih ng
said	s eh d
sailboat	s ey l b ow t
sailed	s ey l d
sailors	s ey l er z
salad	s ae l ah d #1
salads	s ae l ah d z
salary	s ae l er iy
sale	s ey l #1
salesmanship	s ey l z m ah n sh ih p
salesmen	s ey l z m ah n #1
salt	s aa l t #1
salted	s aa l t ih d
salvation	s ae l v ey sh ih n
same	s ey m
sample	s ae m p l #1
samples	s ae m p l z
sampling	s ae m p l ih ng
sandwich	s ae n d w ih ch
sank	s ae ng k
sarcasm	s aa r k ae z m
sat	s ae t #1
satellites	s ae t ah l ay t s
satirical	s ae t ih r ih k l
satisfaction	s ae t ih s f ae k sh ih n
satisfy	s ae t ih s f ay
saturated	s ae ch uh r ey t ih d
saturday	s ae t er d ey
sauce	s aa s
sauerkraut	s aw er k r aw t
savagely	s ae v ih jh l iy
save	s ey v #1
saved	s ey v d
saw	s aa #1
saws	s aa z
say	s ey #1
saying	s ey ih ng
says	s eh z
scabbard	s k ae b er d
scaffold	s k ae f l d
scalloped	s k aa l ah p t
scalp	s k ae l p
scampered	s k ae m p er d
scar	s k aa r #1
scared	s k ae r d
scarf	s k aa r f
scattered	s k ae t er d
scenery	s iy n er iy
scenes	s iy n z
schedule	s k eh jh l
schnooks	sh n uh k s
scholar	s k aa l er #1
scholars	s k aa l er z
scholastic	s k ah l ae s t ih k
school	s k uw l #1
schools	s k uw l z
schooner	s k uw n er
scientific	s ay ih n t ih f ih k
scientists	s ay ih n t ih s t s
scoop	s k uw p
score	s k aa r #2
scored	s k aa r d
scour	s k aw r #1
scouring	s k aw r ih ng
scout's	s k aw t s
scowled	s k aw l d
scraping	s k r ey p ih ng
scratch	s k r ae ch
scream	s k r iy m
screeched	s k r iy ch t
screen	s k r iy n
screw	s k r uw #1
screwdriver	s k r uw d r ay v er
sculptor	s k ah l p t er
sculpture	s k ah l p ch er
se	s ey #2
sea	s iy #1
seam	s iy m #1
seamstresses	s iy m s t r eh s ih z
sear	s ih r #1
search	s er ch
season	s iy z n #1
seasoning	s iy z n ih ng
seats	s iy t s
seattle	s iy ae t l
second	s eh k ih n d #1
secondary	s eh k ih n d eh r iy
secret	s iy k r ih t
section	s eh k sh ih n
sector	s eh k t er
secularist	s eh k y uh l er ih s t
secured	s ih k y uh r d
security	s ih k y uh r ih t iy
see	s iy #2
seed	s iy d #1
seeds	s iy d z
seeing	s iy ih ng
seeker	s iy k er #1
seekers	s iy k er z
seeking	s iy k ih ng
seem	s iy m #2
seemed	s iy m d
seems	s iy m z
seen	s iy n #1
seismic	s ay z m ih k
seldom	s eh l d ah m
selected	s ah l eh k t ih d
selecting	s ah l eh k t ih ng
selection	s ah l eh k sh ih n #1
selections	s ah l eh k sh ih n z
selective	s ah l eh k t ih v
self	s eh l f #1
self's	s eh l f s #1
self-confident	s eh l f k aa n f ih d ih n t
self-contained	s eh l f k ah n t ey n d
self-deceiving	s eh l f d ih s iy v ih ng
self-sufficiency	s eh l f s ah f ih sh ih n s iy
seller	s eh l er
semi-	s eh m ih #1
semi-heights	s eh m ih hh ay t s
semidrying	s eh m ih d r ay ih ng
senate	s eh n ih t
send	s eh n d #1
sending	s eh n d ih ng
senior	s iy n y er
sense	s eh n s #1
sensibly	s eh n s ih b l iy
sensitive	s eh n s ih t ih v
sensory	s eh n s er iy
sensual	s eh n sh uw l
sentiment	s eh n t ah m ah n t
separate~adj	s eh p r ah t
separate~v	s eh p er ey t
sequoia	s ih k w oy ah
series	s ih r iy z
sermon	s er m ah n
serpent's	s er p ah n t s
serve	s er v #1
served	s er v d
serves	s er v z
service	s er v ah s #1
services	s er v ah s ih z
sesame	s eh s ah m iy
set	s eh t #1
sets	s eh t s
setting	s eh t ih ng
settle	s eh t l
seven	s eh v ah n #1
seventh	s eh v ah n th
seventy	s eh v ah n t iy
several	s eh v er l
severe	s ah v ih r
sew	s ow #1
sewers	s uw er z
sewing	s ow ih ng
sex	s eh k s
sexual	s eh k sh uw l
sexually	s eh k sh uh l iy
shabby	sh ae b iy
shackles	sh ae k l z
shade	sh ey d #1
shadow	sh ae d ow
shady	sh ey d iy
shaft	sh ae f t
shag	sh ae g
shaken	sh ey k ih n
shaker	sh ey k er #1
shakers	sh ey k er z
shaky	sh ey k iy
shall	sh ae l #1
shallowness	sh ae l ow n ih s
shame	sh ey m
shampoo	sh ae m p uw #1
shampooed	sh ae m p uw d
shape	sh ey p #1
shaped	sh ey p t
shapes	sh ey p s
share	sh ae r
sharks	sh aa r k s
sharp	sh aa r p
shattered	sh ae t er d
shaving	sh ey v ih ng
shawls	sh aa l z
shawn	sh aa n
she	sh iy #1
she'd	sh iy d
she's	sh iy z
shed	sh eh d
sheets	sh iy t s
sheik	sh iy k
sheila	sh iy l ah
shell	sh eh l #1
shellfish	sh eh l f ih sh
shelter	sh eh l t er #1
sheltered	sh eh l t er d
shelters	sh eh l t er z
shelves	sh eh l v z
sherbet	sh er b ih t
sheriff	sh eh r ih f #1
sheriff's	sh eh r ih f s
shielding	sh iy l d ih ng
shimmered	sh ih m er d
shimmering	sh ih m er ih ng
shimmers	sh ih m er z
ship	sh ih p #1
ship's	sh ih p s #1
shipbuilding	sh ih p b ih l d ih ng
shipmate	sh ih p m ey t
ships	sh ih p s #2
shipshape	sh ih p sh ey p
shirt	sh er t #1
shirtsleeve	sh er t s l iy v
shivering	sh ih v er ih ng
shock	sh aa k #1
shocked	sh aa k t
shocking	sh aa k ih ng
shocks	sh aa k s
shoelaces	sh uw l ey s ih z
shoes	sh uw z
shone	sh ow n #1
shook	sh uh k
shoot	sh uw t
shop	sh aa p #1
shopkeepers	sh aa p k iy p er z
shore	sh aa r #1
short	sh aa r t #1
shortage	sh aa r t ih jh
shorten	sh aa r t n
shortly	sh aa r t l iy
shot	sh aa t
should	sh uh d
shoulder	sh ow l d er
shouted	sh aw t ih d
shove	sh ah v #1
shovels	sh ah v l z
shoving	sh ah v ih ng
show	sh ow #1
showed	sh ow d
showering	sh aw er ih ng
showers	sh aw er z
showing	sh ow ih ng
shown	sh ow n #2
shows	sh ow z
shrapnel	sh r ae p n l
shredded	sh r eh d ih d
shredder	sh r eh d er
shrieked	sh r iy k t
shrimp	sh r ih m p
shrinking	sh r ih ng k ih ng
shrubs	sh r ah b z
shrugged	sh r ah g d
shrugs	sh r ah g z
shucks	sh ah k s
shuddering	sh ah d er ih ng
shuffle	sh ah f l
shut	sh ah t #1
shutter	sh ah t er
shy	sh ay
siamese	s ay ah m iy z
sick	s ih k #1
side	s ay d #1
sides	s ay d z
sidewinder	s ay d w ay n d er
sigh	s ay #1
sighing	s ay ih ng
sightseers	s ay t s iy er z
sign	s ay n #1
signals	s ih g n l z
signed	s ay n d
significant	s ih g n ih f ih k ah n t
signs	s ay n z
silence	s ay l ah n s
silent	s ay l ah n t
silhouette	s ih l ow eh t
silky	s ih l k iy
silly	s ih l iy
silver	s ih l v er #1
silverware	s ih l v er w ae r
simmer	s ih m er
simple	s ih m p l #1
simpler	s ih m p l er
simplest	s ih m p l ah s t
simply	s ih m p l iy
sin	s ih n #1
since	s ih n s #1
sincere	s ih n s ih r
sincerity	s ih n s eh r ih t iy
sinewy	s ih n y uw iy
sing	s ih ng #1
singer's	s ih ng g er z
single	s ih ng g l #1
single-handed	s ih ng g l hh ae n d ih d
singular	s ih ng g y uh l er
sinuous	s ih n y uw ih s
sinus	s ay n ih s
sir	s er #1
sit	s ih t #1
site	s ay t #1
sitting	s ih t ih ng
situated	s ih ch uw ey t ih d
situation	s ih ch uw ey sh ih n #1
situations	s ih ch uw ey sh ih n z
six	s ih k s #1
sixty	s ih k s t iy #1
sixty-five	s ih k s t iy f ay v
size	s ay z #1
sized	s ay z d
sizzled	s ih z l d
skating	s k ey t ih ng
sketched	s k eh ch t
skewers	s k y uw er z
ski	s k iy #1
skiffs	s k ih f s
skiing	s k iy ih ng
skill	s k ih l #1
skilled	s k ih l d
skills	s k ih l z
skin	s k ih n #1
skinless	s k ih n l ah s
skirmish	s k er m ih sh
skirt	s k er t #1
skirts	s k er t s
sky	s k ay #1
skywave	s k ay w ey v
slammed	s l ae m d
slanted	s l ae n t ih d
slapped	s l ae p t
slash	s l ae sh
slate	s l ey t
slavery	s l ey v er iy
sleep	s l iy p #1
sleepily	s l iy p ah l iy
sleeping	s l iy p ih ng
sleepy	s l iy p iy
sleigh	s l ey #1
slept	s l eh p t
slid	s l ih d
slightly	s l ay t l iy
slip	s l ih p #1
slipped	s l ih p t
slipping	s l ih p ih ng
slips	s l ih p s
slope	s l ow p #1
slopes	s l ow p s
sloppy	s l aa p iy
slovenliness	s l aa v n l iy n ih s
slow	s l ow #1
slowed	s l ow d
slowly	s l ow l iy
sludge	s l ah jh
slug	s l ah g #1
slugging	s l ah g ih ng
sluicing	s l uw s ih ng
slums	s l ah m z
slyly	s l ay l iy
slyness	s l ay n ih s
small	s m aa l
smash	s m ae sh #1
smashed	s m ae sh t
smell	s m eh l #1
smelled	s m eh l d
smile	s m ay l #1
smiled	s m ay l d
smiles	s m ay l z
smiling	s m ay l ih ng
smiths	s m ih th s
smoke	s m ow k
smolderingly	s m ow l d er ih ng l iy
smooth	s m uw dh #1
smoothed	s m uw dh d
smothered	s m ah dh er d
snake	s n ey k #1
snake-rail	s n ey k r ey l
snakes	s n ey k s
snapper	s n ae p er
snapping	s n ae p ih ng
snarled	s n aa r l d
snatched	s n ae ch t
sneezed	s n iy z d
snips	s n ih p s
snow	s n ow #1
snowed	s n ow d
so	s ow #2
so-called	s ow k aa l d
soak	s ow k #1
soaked	s ow k t
sober	s ow b er
social	s ow sh l
socialized	s ow sh ah l ay z d
society	s ih s ay ah t iy
socks	s aa k s
soft	s aa f t #1
softly	s aa f t l iy
soil	s oy l #1
soils	s oy l z
solar	s ow l er
sold	s ow l d
soldiering	s ow l jh er ih ng
soldiers	s ow l jh er z
solicits	s ah l ih s ih t s
solid	s aa l ih d #1
solid-state	s aa l ih d s t ey t
solidarity	s aa l ah d ae r ah t iy
solitary	s aa l ih t eh r iy
solitude	s aa l ih t uw d
solution	s ah l uw sh ih n
solve	s aa l v #1
solved	s aa l v d
solves	s aa l v z
some	s ah m #1
somebody	s ah m b aa d iy #1
somebody'll	s ah m b aa d iy l
somehow	s ah m hh aw
someone	s ah m w ah n
someplace	s ah m p l ey s
something	s ah m th ih ng
sometime	s ah m t ay m #1
sometimes	s ah m t ay m z
somewhat	s ah m hh w aa t
somewhere	s ah m hh w ae r
son	s ah n #1
song	s aa ng #1
songs	s aa ng z
sonic	s aa n ih k
soon	s uw n
soothe	s uw dh #1
soothed	s uw dh d
soothingly	s uw dh ih ng l iy
sophisticated	s ah f ih s t ih k ey t ih d
sophistication	s ah f ih s t ih k ey sh ih n
sorcery	s aa r s er iy
sordid	s aa r d ih d
sorrow	s aa r ow
sorry	s aa r iy
sort	s aa r t
sought	s aa t
soul	s ow l #1
souls	s ow l z
sound	s aw n d #1
sounded	s aw n d ih d
soup	s uw p #1
sour	s aw er #1
source	s aa r s #1
sources	s aa r s ih z
south	s aw th #1
southwest	s aw th w eh s t
soybean	s oy b iy n #1
soybeans	s oy b iy n z
soysauce	s oy s aa s
space	s p ey s #1
spaced	s p ey s t
spade	s p ey d #1
spades	s p ey d z
spanish	s p ae n ih sh
spatial	s p ey sh l
speak	s p iy k #1
speaker	s p iy k er
special	s p eh sh l #1
specialty	s p eh sh l t iy
species	s p iy sh iy z
specific	s p ah s ih f ih k
spectacular	s p eh k t ae k y uh l er
spectator	s p eh k t ey t er #1
spectator-type	s p eh k t ey t er t ay p
speculated	s p eh k y uh l ey t ih d
speculations	s p eh k y uh l ey sh ih n z
speech	s p iy ch
spend	s p eh n d #1
spending	s p eh n d ih ng
spent	s p eh n t
sphere	s f ih r #1
spherical	s f ih r ih k l
spider	s p ay d er
spike	s p ay k
spilled	s p ih l d
spinach	s p ih n ih ch
spirit	s p ih r ih t #1
spirited	s p ih r ih t ih d
spirits	s p ih r ih t s
spiritual	s p ih r ih ch uw l
spit	s p ih t
splashed	s p l ae sh t
splendidly	s p l eh n d ih d l iy
splendor	s p l eh n d er
splinter	s p l ih n t er
splurge	s p l er jh #1
splurged	s p l er jh d
spoilage	s p oy l ih jh
spoiled	s p oy l d
spoke	s p ow k #1
spoken	s p ow k ih n
spokes	s p ow k s
sponges	s p ah n jh ih z
sponsors	s p aa n s er z
sport	s p aa r t #1
sports	s p aa r t s #1
sportsmen	s p aa r t s m ah n
spot	s p aa t #1
spotted	s p aa t ih d
spouted	s p aw t ih d
sprained	s p r ey n d
sprang	s p r ae ng
spray	s p r ey #1
spread	s p r eh d #1
spreader	s p r eh d er
spring	s p r ih ng #1
sprinkling	s p r ih ng k l ih ng
sprouted	s p r aw t ih d
sprouting	s p r aw t ih ng
spun	s p ah n #1
spurious	s p y uh r iy ah s
spurs	s p er z
sputniks	s p ah t n ih k s
square	s k w ae r #1
squared	s k w ae r d
squashy	s k w aa sh iy
squeaked	s k w iy k t
squeamishness	s k w iy m ih sh n ih s
squeezed	s k w iy z d
squelched	s k w eh l ch t
stab	s t ae b
stable	s t ey b l
stacked	s t ae k t
staff	s t ae f
stag	s t ae g #1
stage	s t ey jh
staggered	s t ae g er d
stake	s t ey k #1
stake-out	s t ey k aw t
stampede	s t ae m p iy d
stand	s t ae n d #1
standardized	s t ae n d er d ay z d
standards	s t ae n d er d z
standby	s t ae n d b ay
star	s t aa r #1
starchy	s t aa r ch iy
stared	s t ae r d
start	s t aa r t #1
started	s t aa r t ih d
startling	s t aa r t l ih ng
state	s t ey t #1
statement	s t ey t m ah n t
states	s t ey t s
statue	s t ae ch uw #1
statuesque	s t ae ch uw eh s k
status	s t ae t ih s
statutory	s t ae ch ah t aa r iy
stay	s t ey #1
stayed	s t ey d
steam	s t iy m #1
steaming	s t iy m ih ng
steel	s t iy l
steep	s t iy p
stems	s t eh m z
step	s t eh p #1
steph	s t eh f
stepladders	s t eh p l ae d er z
stepmother	s t eh p m ah dh er
steps	s t eh p s
sterilization	s t eh r l ah z ey sh ih n
steve	s t iy v
stew	s t uw #1
stick	s t ih k
stiffly	s t ih f l iy
still	s t ih l
stimulates	s t ih m y uw l ey t s
stimulating	s t ih m y uw l ey t ih ng
stinging	s t ih ng ih ng
stings	s t ih ng z
stirred	s t er d
stirrin	s t er n
stirrup	s t er ah p #1
stirrup-guard	s t er ah p g aa r d
stock	s t aa k #1
stockings	s t aa k ih ng z
stockroom	s t aa k r uw m
stoicism	s t ow ah s ih z m
stole	s t ow l
stomach	s t ah m ah k
stomped	s t aa m p t
stone	s t ow n #1
stoneware	s t ow n w ae r
stood	s t uh d
stool	s t uw l
stoop	s t uw p #1
stop	s t aa p #1
stopped	s t aa p t
stopping	s t aa p ih ng
stopwatch	s t aa p w aa ch
store	s t aa r #2
stored	s t aa r d
storm	s t aa r m #1
storms	s t aa r m z
story	s t aa r iy #1
storyline	s t aa r iy l ay n #1
storylines	s t aa r iy l ay n z
straight	s t r ey t #1
straightened	s t r ey t n d
straightforward	s t r ey t f aa r w er d
strain	s t r ey n #1
strained	s t r ey n d
stranded	s t r ae n d ih d
stranger	s t r ey n jh er
strategic	s t r ah t iy jh ih k
strategy	s t r ae t ih jh iy
straw	s t r aa #1
strawberries	s t r aa b eh r iy z
strawberry	s t r aa b eh r iy #1
stray	s t r ey #1
stream	s t r iy m #1
streamed	s t r iy m d
streamlined	s t r iy m l ay n d
streams	s t r iy m z
street	s t r iy t #1
streets	s t r iy t s
strength	s t r eh ng th #1
strengthen	s t r eh ng th ih n
stress	s t r eh s
stretched	s t r eh ch t
strike	s t r ay k #1
strikingly	s t r ay k ih ng l iy
strip	s t r ih p #1
striped	s t r ay p t
stripped	s t r ih p t
strippers	s t r ih p er z
strolled	s t r ow l d
strong	s t r aa ng #1
stronghold	s t r aa ng hh ow l d
strongly	s t r aa ng l iy
struck	s t r ah k #1
structural	s t r ah k ch er l
structure	s t r ah k ch er #1
structures	s t r ah k ch er z
struggle	s t r ah g l #1
struggling	s t r ah g l ih ng
stuck	s t ah k
students	s t uw d n t s #1
students'	s t uw d n t s #2
studio	s t uw d iy ow
study	s t ah d iy
stumping	s t ah m p ih ng
stung	s t ah ng
stupid	s t uw p ih d
style	s t ay l #1
stylish	s t ay l ih sh
subdued	s ah b d uw d
subgroups	s ah b g r uw p s
subject	s ah b jh ih k t
subjective	s ah b jh eh k t ih v
submarine	s ah b m er iy n
submit	s ah b m ih t
substances	s ah b s t ih n s ih z
substantial	s ah b s t ae n sh l
substantially	s ah b s t ae n sh ah l iy
subsystems	s ah b s ih s t ah m z
subtitles	s ah b t ay t l z
subtraction	s ah b t r ae k sh ih n
suburban	s ah b er b ih n #1
suburbanites	s ah b er b ih n ay t s
suburbs	s ah b er b z
subway	s ah b w ey
succeeding	s ah k s iy d ih ng
success	s uh k s eh s #1
successful	s uh k s eh s f uh l #1
successfully	s uh k s eh s f uh l iy
successors	s uh k s eh s er z
such	s ah ch
sucking	s ah k ih ng
sudden	s ah d n #1
suddenly	s ah d n l iy
suey	s uw iy
suffer	s ah f er #1
suffered	s ah f er d
suffers	s ah f er z
sufficiency	s ah f ih sh ih n s iy
sufficient	s ah f ih sh ih n t #1
sufficiently	s ah f ih sh ih n t l iy
sugar	sh uh g er
suggestion	s ah jh eh s ch n
suicide	s uw ah s ay d
suit	s uw t #1
suitable	s uw t ah b l #1
suitably	s uw t ah b l iy
suite	s w iy t #1
sullen	s ah l ah n
sulphur	s ah l f er
sum	s ah m #2
summer	s ah m er #1
summertime	s ah m er t ay m
sun	s ah n #2
sunburn	s ah n b er n #1
sunburned	s ah n b er n d
sundae	s ah n d ey
sundown	s ah n d aw n
sung	s ah ng
sunlight	s ah n l ay t
sunshine	s ah n sh ay n
superb	s uh p er b #1
superbly	s uh p er b l iy
superior	s ah p ih r iy er #1
superiors	s ah p ih r iy er z
supervision	s uw p er v ih sh ih n
supervisory	s uw p er v ay z er iy
supper	s ah p er #1
suppers	s ah p er z
supplements	s ah p l ah m ah n t s
supplies	s ah p l ay z
supporters	s ah p aa r t er z
supports	s ah p aa r t s
suppose	s ah p ow z
supreme	s ah p r iy m
sure	sh uh r #1
sure-sure	sh uh r sh uh r
surely	sh uh r l iy
surface	s er f ah s #1
surfaceness	s er f ah s n ih s
surfaces	s er f ah s ih z
surfeit	s er f ah t
surgeon	s er jh ih n
surplus	s er p l ah s
surprise	s er p r ay z #1
surprising	s er p r ay z ih ng #1
surprisingly	s er p r ay z ih ng l iy
surrender	s er eh n d er
surrounded	s er aw n d ih d
survey	s er v ey #1
surveying	s er v ey ih ng
survival	s er v ay v l
survive	s er v ay v #1
susceptible	s ih s eh p t ah b l
suspect	s ih s p eh k t
suspiciously	s ih s p ih sh ah s l iy
swam	s w ae m
swarmed	s w aa r m d
swarthy	s w aa r dh iy
swatches	s w aa ch ih z
sweat	s w eh t #1
sweater	s w eh t er #1
sweaters	s w eh t er z
swedish	s w iy d ih sh
sweet	s w iy t #2
sweet-sour	s w iy t s aw er
sweetheart	s w iy t hh aa r t
sweetly	s w iy t l iy
swells	s w eh l z
swiftly	s w ih f t l iy
swig	s w ih g
swimming	s w ih m ih ng
swing	s w ih ng
swirled	s w er l d
swiss	s w ih s
switched	s w ih ch t
switches	s w ih ch ih z
swivel	s w ih v l
swollen	s w ow l ih n
swung	s w ah ng
symbolic	s ih m b aa l ih k
symbolism	s ih m b ah l ih z m
symbolize	s ih m b ah l ay z
symbols	s ih m b l z
symmetrical	s ah m eh t r ih k l
sympathetically	s ih m p ah th eh t ih k ah l iy
symposium	s ih m p ow z iy ah m
symptom	s ih m p t ah m
synagogue	s ih n ih g aa g
synonymous	s ih n aa n ah m ah s
syrup	s ih r ah p
system	s ih s t ah m #1
systems	s ih s t ah m z
table	t ey b l #1
tablecloths	t ey b l k l aa th s
tables	t ey b l z
tackle	t ae k l
tad	t ae d #1
tadpole	t ae d p ow l
tag	t ae g
tail	t ey l #1
tailored	t ey l er d
tails	t ey l z
take	t ey k #1
taken	t ey k ih n
takes	t ey k s
takin'	t ey k n
taking	t ey k ih ng
tale	t ey l #2
talent	t ae l ih n t
talk	t aa k #1
talked	t aa k t
talking	t aa k ih ng
tall	t aa l #1
tallyho	t ae l iy hh ow
tame	t ey m
tan	t ae n #1
tank	t ae ng k
tantalizing	t ae n t ah l ay z ih ng
tape	t ey p #1
tapes	t ey p s
tapestry	t ae p ah s t r iy
target	t aa r g ih t #1
targets	t aa r g ih t s
task	t ae s k #1
tasks	t ae s k s
tasteful	t ey s t f uh l
tastes	t ey s t s
taut	t aa t
tax	t ae k s #1
tax-aided	t ae k s ey d ih d
taxation	t ae k s ey sh ih n
taxi	t ae k s iy #1
taxicab	t ae k s iy k ae b
taxpayer	t ae k s p ey er
tea	t iy #1
teach	t iy ch #1
teacher	t iy ch er
teaching	t iy ch ih ng
team	t iy m #1
tears	t ih r z
teased	t iy z d
teaspoons	t iy s p uw n z
technical	t eh k n ih k l
technique	t eh k n iy k #1
techniques	t eh k n iy k s
technological	t eh k n ah l aa jh ih k l
technology	t eh k n aa l ah jh iy
teems	t iy m z
teeth	t iy th
telephone	t eh l ah f ow n #1
telephoning	t eh l ah f ow n ih ng
tell	t eh l #1
tellers	t eh l er z
tells	t eh l z
temper	t eh m p er #1
temperate	t eh m p er ih t
tempo	t eh m p ow
temptation	t eh m p t ey sh ih n #1
temptations	t eh m p t ey sh ih n z
tempted	t eh m p t ih d
ten	t eh n #1
tenant	t eh n ih n t #1
tenant's	t eh n ih n t s
tend	t eh n d #1
tended	t eh n d ih d
tenderness	t eh n d er n ih s
tends	t eh n d z
tensely	t eh n s l iy
tension	t eh n sh ih n
tentacles	t eh n t ih k l z
tenure	t eh n y er
term	t er m #1
terms	t er m z
terrible	t eh r ah b l
terrier	t eh r iy er
terrific	t er ih f ih k
terrifying	t eh r ah f ay ih ng
test	t eh s t #1
test-run	t eh s t r ah n
testicle	t eh s t ih k l
testimony	t eh s t ih m ow n iy
tests	t eh s t s
tetanus	t eh t n ih s
tethered	t eh dh er d
text	t eh k s t #1
text-form	t eh k s t f aa r m
texts	t eh k s t s
texture	t eh k s ch er
than	dh ae n
thank	th ae ng k #1
thanks	th ae ng k s #1
thanksgiving	th ae ng k s g ih v ih ng
that	dh ae t #1
that'll	dh ae t l
that's	dh ae t s
thaw	th aa #1
the	dh ah #1
theaters	th iy t er z
their	dh ae r #1
theirs	dh ae r z #1
them	dh eh m #1
theme	th iy m #1
themes	th iy m z
themselves	dh eh m s eh l v z
then	dh eh n
theocracy	th iy aa k r ih s iy
theory	th ih r iy
therapies	th eh r ah p iy z
therapy	th eh r ah p iy #1
there	dh ae r #2
there's	dh ae r z #2
thereafter	dh ae r ae f t er
thereby	dh ae r b ay
thereupon	dh ae r ah p aa n
thermal	th er m l
thermometer	th er m aa m ah t er #1
thermometers	th er m aa m ah t er z
thermonuclear	th er m ow n uw k l iy er
these	dh iy z
they	dh ey #1
they'd	dh ey d
they'll	dh ey l
they're	dh ae r #3
they've	dh ey v
thick	th ih k
thief	th iy f
thighs	th ay z
thimble	th ih m b l
thin	th ih n #1
thing	th ih ng #1
things	th ih ng z
think	th ih ng k #1
thinker	th ih ng k er
thinkin	th ih ng k ih n
thinking	th ih ng k ih ng
thinks	th ih ng k s
thinner	th ih n er
third	th er d
thirty	th er t iy #1
thirty-five	th er t iy f ay v
this	dh ih s
thomas	t aa m ih s
thoroughbred	th er ow b r eh d
thoroughfares	th er ow f ae r z
thoroughly	th er ow l iy
those	dh ow z
thou	dh aw
though	dh ow #1
thought	th aa t #1
thoughtless	th aa t l ih s
thousand	th aw z n d
thread	th r eh d
threatening	th r eh t n ih ng
three	th r iy #1
three-inch	th r iy ih n ch
threw	th r uw #1
thrill	th r ih l
thrived	th r ay v d
throat	th r ow t
thrombosis	th r aa m b ow s ih s
through	th r uw #2
throughout	th r uw aw t
throw	th r ow #1
thrower	th r ow er
thrusting	th r ah s t ih ng
thruway	th r uw w ey
thump	th ah m p
thursday's	th er z d ey z #1
thursdays	th er z d ey z #2
thus	dh ah s
thwarted	th w aa r t ih d
thyroid	th ay r oy d
tidbits	t ih d b ih t s
tides	t ay d z
tie	t ay #1
tied	t ay d #1
tight	t ay t #1
tiles	t ay l z
tilted	t ih l t ih d
tim	t ih m #1
timber	t ih m b er
time	t ay m #1
timers	t ay m er z
times	t ay m z
timing	t ay m ih ng
tin	t ih n #1
tinder	t ih n d er
tinkled	t ih ng k l d
tinsel	t ih n s l
tiny	t ay n iy
tips	t ih p s
tired	t ay er d
tissue	t ih sh uw
title	t ay t l
titter	t ih t er
to	t uw #1
toast	t ow s t
tobacco	t ah b ae k ow
today	t ih d ey #1
today'll	t ih d ey l
today's	t ih d ey z
todd	t aa d #1
toddler	t aa d l er
toe	t ow #1
tofu	t ow f uw
together	t ih g eh dh er
toilet	t oy l ih t
told	t ow l d
tolerated	t aa l er ey t ih d
toll	t ow l #1
tom	t aa m #1
tomblike	t uw m l ay k
tomboy	t aa m b oy
tombstones	t uw m s t ow n z
tomorrow	t ah m aa r ow
tongue	t ah ng
too	t uw #2
too-naked	t uw n ey k ih d
took	t uh k
tool	t uw l
tooth	t uw th #1
toothbrush	t uw th b r ah sh
toothpaste	t uw th p ey s t
top	t aa p #1
topography	t ah p aa g r ah f iy
topping	t aa p ih ng
tore	t aa r #1
torn	t aa r n #1
tornados	t aa r n ey d ow z
toss	t aa s #1
tossed	t aa s t
total	t ow t l
touch	t ah ch #1
touchdown	t ah ch d aw n
touched	t ah ch t
touches	t ah ch ih z
tough	t ah f
tour	t uh r
toward	t aa r d #1
towards	t aa r d z
towel	t aw l
town	t aw n
toxic	t aa k s ih k
toy	t oy #1
traced	t r ey s t
track	t r ae k #1
tracks	t r ae k s
trade	t r ey d
tradition	t r ah d ih sh ih n #1
traditionalism	t r ah d ih sh ih n l ih z m
traffic	t r ae f ih k
tragedy	t r ae jh ih d iy
tragic	t r ae jh ih k
trail	t r ey l
train	t r ey n #1
training	t r ey n ih ng
trait	t r ey t #1
traits	t r ey t s
tranquilizers	t r ae ng k w ih l ay z er z
transact	t r ae n s ae k t
transcendence	t r ae n s eh n d ih n s
transience	t r ae n s iy ih n s
transit	t r ae n s ih t
translated	t r ae n s l ey t ih d
transmit	t r ae n s m ih t
transparent	t r ae n s p ae r ah n t
trap	t r ae p
trauma	t r aa m ah
travel	t r ae v l #1
traveler	t r ae v l er #1
travelers	t r ae v l er z
travelled	t r ae v l d
tray	t r ey #1
treated	t r iy t ih d
treatment	t r iy t m ah n t
treats	t r iy t s
tree	t r iy #1
trees	t r iy z
trembled	t r eh m b l d
tremor	t r eh m er
tremulously	t r eh m y uh l ah s l iy
trend	t r eh n d #1
trend-following	t r eh n d f aa l ow ih ng
trends	t r eh n d z
trespassing	t r eh s p ae s ih ng
trial	t r ay l #1
trials	t r ay l z
tribes	t r ay b z
trick	t r ih k
tried	t r ay d
tries	t r ay z
trifle	t r ay f l
triggered	t r ih g er d
trim	t r ih m
trip	t r ih p #1
trips	t r ih p s
trish	t r ih sh
triumphant	t r ay ah m f ah n t
triviality	t r ih v iy ae l ih t iy
tropical	t r aa p ih k l
trouble	t r ah b l
trousers	t r aw z er z
truck	t r ah k #1
trucks	t r ah k s
true	t r uw #1
truism	t r uw ih z m
truly	t r uw l iy
trunks	t r ah ng k s
trustworthy	t r ah s t w er dh iy
truth	t r uw th
try	t r ay #1
trying	t r ay ih ng
tsunami	t s uw n aa m iy
tub	t ah b #1
tube	t uw b
tugboats	t ah g b ow t s
tumbled	t ah m b l d
tunafish	t uw n ah f ih sh
tunnels	t ah n l z
turbulent	t er b y uh l ah n t
turmoil	t er m oy l
turn	t er n #1
turned	t er n d
turnpikes	t er n p ay k s
turns	t er n z
turpentine	t er p ah n t ay n
turquoise	t er k oy z
tweezers	t w iy z er z
twelfth	t w eh l f th
twelve	t w eh l v
twenty	t w eh n t iy #1
twenty-five	t w eh n t iy f ay v
twenty-nine	t w eh n t iy n ay n
twenty-three	t w eh n t iy th r iy
twenty-two	t w eh n t iy t uw
twice	t w ay s
twigged	t w ih g d
twilight	t w ay l ay t
twins	t w ih n z
twisted	t w ih s t ih d
twitched	t w ih ch t
two	t uw #3
twofold	t uw f ow l d
tycoons	t ay k uw n z
type	t ay p #1
types	t ay p s
typhoid	t ay f oy d
typhus	t ay f ah s
typical	t ih p ih k l #1
typically	t ih p ih k l iy
tyrannical	t ih r ae n ih k l
tyranny	t ih r ae n iy
ugly	ah g l iy
ultrasonic	ah l t r ah s aa n ih k
umbrella	ah m b r eh l ah
unabashed	ah n ah b ae sh t
unanimity	y uw n ih n ih m ah t iy
unappreciated	ah n ah p r iy sh iy ey t ih d
unauthentic	ah n aa th eh n t ih k
unavailable	ah n ah v ey l ih b l
unbeatable	ah n b iy t ah b l
unbelievable	ah n b ah l iy v ah b l
unbound	ah n b aw n d
unbroken	ah n b r ow k ih n
uncertain	ah n s er t n
uncomfortable	ah n aa ah m f er t ah b l
uncommon	ah n k aa m ah n
unconvincing	ah n k ah n v ih n s ih ng
uncover	ah n k ah v er
undeniably	ah n d iy n ay ah b l iy
under	ah n d er #1
under-age	ah n d er ey jh
underbrush	ah n d er b r ah sh
underfoot	ah n d er f uh t
understand	ah n d er s t ae n d #1
understanding	ah n d er s t ae n d ih ng #1
understandingly	ah n d er s t ae n d ih ng l iy
understood	ah n d er s t uh d
underwriting	ah n d er r ay t ih ng
undesirable	ah n d ih z ay r ah b l
unduly	ah n d uw l iy
uneasily	ah n iy z ah l iy
uneasy	ah n iy z iy
unenthusiastic	ah n ih n th uw z iy ae s t ih k
unevenly	ah n iy v ah n l iy
unexpected	ah n ih k s p eh k t ih d #1
unexpectedly	ah n ih k s p eh k t ih d l iy
unfenced	ah n f eh n s t
unfortunately	ah n f aa r ch ih n ih t l iy
unfortunates	ah n f aa r ch ih n ih t s
unhappy	ah n hh ae p iy
unhurried	ah n hh er iy d
uni-	y uw n iy #1
uni-directional	y uw n iy d er eh k sh ih n l
uniforms	y uw n ih f aa r m z
uninterrupted	ah n ih n t er ah p t ih d
union	y uw n y ih n #1
unions	y uw n y ih n z
uniqueness	y uw n iy k n ih s
unit	y uw n ih t #1
units	y uw n ih t s
unity	y uw n ih t iy
universality	y uw n ih v er s ae l ih t iy
universe	y uw n ah v er s
university	y uw n ih v er s ih t iy #1
university-wide	y uw n ih v er s ih t iy w ay d
unjustified	ah n jh ah s t ih f ay d
unknown	ah n ow n
unless	ah n l eh s
unlimited	ah n l ih m ih t ih d
unlined	ah n l ay n d
unlucky	ah n l ah k iy
unmagnified	ah n m ae g n ih f ay d
unnecessarily	ah n eh s ih s eh r ah l iy
unoccupied	ah n aa k y uw p ay d
unpleasant	ah n p l eh z n t
unquestionably	ah n k w eh s ch ih n ah b l iy
unrealistic	ah n r iy l ih s t ih k
unreasoning	ah n r iy z n ih ng
unseen	ah n s iy n
unspecified	ah n s p eh s ih f ay d
unstuck	ah n s t ah k
unsuspecting	ah n s ah s p eh k t ih ng
until	ah n t ih l
untimely	ah n t ay m l iy
unusual	ah n y uw sh uw l
unusually	ah n y uw sh uw ah l iy
unwaveringly	ah n w ey v er ih ng
up	ah p #1
upbeat	ah p b iy t
upbringing	ah p b r ih ng ih ng
updating	ah p d ey t ih ng
upgrade	ah p g r ey d
uplift	ah p l ih f t
upon	ah p aa n
upper	ah p er
upside	ah p s ay d
upstairs	ah p s t ae r z
upward	ah p w er d
urchins	er ch ih n z
uremia	y uh r iy m iy ah
urethane	y uh r ah th ey n
urge	er jh #1
urged	er jh d
urgent	er jh ih n t
urges	er jh ih z
urging	er jh ih ng
us	ah s #1
usages	y uw s ih jh ih z
used	y uw z d
useful	y uw s f l
useless	y uw s l ah s
uses	y uw z ih z
use~n	y uw s #1
use~v	y uw z #1
using	y uw z ih ng
usual	y uw sh uw l
usually	y uw sh uw ah l iy
utilizing	y uw t ah l ay z ih ng
utmost	ah t m ow s t
utopianism	y uw t ow p iy n ih z m
utopians	y uw t ow p iy n z
utter	ah t er
vacant	v ey k ih n t
vacation	v ey k ey sh ih n
vacuum	v ae k y uw m
vagabond	v ae g ah b aa n d
vaguely	v ey g l iy
vain	v ey n
valiant	v ae l y ah n t
validated	v ae l ah d ey t ih d
validity	v ah l ih d ih t iy
valley	v ae l iy #1
valleys	v ae l iy z
valuables	v ae l y uh b l z
value	v ae l y uw #1
values	v ae l y uw z
vanilla	v ah n ih l ah
vanished	v ae n ih sh t
vanishing	v ae n ih sh ih ng
vanquished	v ae n k w ih sh t
vapor	v ey p er #1
vaporization	v ey p er ah z ey sh ih n
variable	v ae r iy ah b l
variety	v er ay ah t iy
various	v ae r iy ah s
vascular	v ae s k y uh l er
vases	v ey s ih z
vaudeville	v aa d v l
vault	v aa l t #1
vaulting	v aa l t ih ng
veer	v ih r #1
veered	v ih r d
vegetable	v eh jh t ah b l #1
vegetables	v eh jh t ah b l z
vehicles	v iy hh ih k l z
velocities	v ah l aa s ih t iy z
velocity	v ah l aa s ih t iy #1
vending	v eh n d ih ng
ventures	v eh n ch er z
verb	v er b #1
verbal	v er b l
verbalize	v er b ah l ay z
vermouth	v er m uw th
verse	v er s #1
verses	v er s ih z
vertebral	v er t ah b r l
vertigo	v er t ih g ow
very	v eh r iy
veterans'	v eh t er ah n z
veterinarian	v eh t er ah n eh r iy ah n
vices	v ay s ih z
victim	v ih k t ah m #1
victims	v ih k t ah m z
victor	v ih k t er
vietnamese	v iy eh t n aa m iy z
view	v y uw #1
viewpoint	v y uw p oy n t
views	v y uw z
vigilance	v ih jh l ah n s
vigorous	v ih g er ah s
village	v ih l ih jh
villains	v ih l ih n z
violates	v ay ah l ey t s
violence	v ay l ah n s
violent	v ay l ah n t #1
violently	v ay l ah n t l iy
violin	v ay ah l ih n
virtually	v er ch uw ah l iy
virtue	v er ch uw #1
virtues	v er ch uw z
virtuous	v er ch uw ih s
virus	v ay r ih s
visage	v ih z ih jh
viscosity	v ih s k aa s ih t iy
visibly	v ih z ih b l iy
vision	v ih sh ih n
visit	v ih z ih t #1
visiting	v ih z ih t ih ng
visitor	v ih z ih t er #1
visitors	v ih z ih t er z
visual	v ih sh uw l
visually	v ih sh uw ah l iy
vital	v ay t l
vitality	v ay t ae l ih t iy
vitamin	v ay t ah m ah n #1
vitamin-and-iron	v ay t ah m ah n ae n d ay er n
vivid	v ih v ih d #1
vividly	v ih v ih d l iy
vocabulary	v ow k ae b y uh l eh r iy
vocational	v ow k ey sh ih n l
vodka	v aa d k ah
voice	v oy s
voltages	v ow l t ih jh ih z
volume	v aa l y uw m #1
volumes	v aa l y uw m z
volunteered	v aa l ih n t ih r d
volunteers	v aa l ih n t ih r z
votes	v ow t s
voyage	v oy ih jh
wadded	w aa d ih d
wage	w ey jh
wagon	w ae g ih n #1
wagons	w ae g ih n z
wait	w ey t #1
waited	w ey t ih d
waiting	w ey t ih ng
wake	w ey k #1
waking	w ey k ih ng
walk	w aa k #1
walked	w aa k t
walking	w aa k ih ng
wall	w aa l #1
walls	w aa l z
wandered	w aa n d er d
wanna	w ah n ah #1
want	w aa n t #1
wanted	w aa n t ih d
wants	w aa n t s
war	w aa r #1
ward	w aa r d #1
wardrobe	w aa r d r ow b
warfare	w aa r f ae r
warlike	w aa r l ay k
warm	w aa r m #1
warmish	w aa r m ih sh
warmongering	w aa r m aa ng g er ih ng
warmth	w aa r m th
warn	w aa r n #1
warningly	w aa r n ih ng l iy
warping	w aa r p ih ng
warrior	w aa r iy er
was	w ah z #1
wash	w aa sh #1
washer	w aa sh er
washing	w aa sh ih ng #1
washington	w aa sh ih ng t ah n
wasn't	w ah z n t
wasp	w aa s p
waste	w ey s t
watch	w aa ch #1
watched	w aa ch t
watches	w aa ch ih z
water	w aa t er #1
waters	w aa t er z
wave	w ey v #1
wave-setting	w ey v s eh t ih ng
waves	w ey v z
wax	w ae k s #1
waxing	w ae k s ih ng
waxy	w ae k s iy
way	w ey #1
ways	w ey z
we	w iy #1
we'd	w iy d
we'll	w ih l #1
we're	w ih r #1
we've	w iy v #1
weakens	w iy k ih n z
weakness	w iy k n ih s
wealth	w eh l th #1
wealthy	w eh l th iy
weapon	w eh p ah n
wear	w ae r
weary	w ih r iy
weather	w eh dh er #1
weatherproof	w eh dh er p r uw f
weatherstrip	w eh dh er s t r ih p
weave	w iy v #2
web	w eh b #1
webbed	w eh b d
wedded	w eh d ih d
wedding	w eh d ih ng
week	w iy k #1
weekday	w iy k d ey
weekend	w iy k eh n d
weeks	w iy k s
weeping	w iy p ih ng
welcome	w eh l k ah m #1
welcomed	w eh l k ah m d
welfare	w eh l f ae r
well	w eh l #1
well-kept	w eh l k eh p t
well-made	w eh l m ey d
went	w eh n t
were	w er #1
weren't	w er n t
westchester	w eh s ch eh s t er
wet	w eh t
what	hh w aa t #1
what're	hh w aa t er
what's	hh w aa t s #1
what's-his-name	hh w aa t s hh ih z n ey m
whatever	hh w ah t eh v er
whatsoever	hh w aa t s ow eh v er
wheat	hh w iy t
wheel	hh w iy l #1
wheels	hh w iy l z
when	hh w eh n #1
whenever	hh w eh n eh v er
where	hh w ae r #1
where're	hh w ae r er
wherever	hh w ae r eh v er
whether	w eh dh er #2
which	hh w ih ch
while	hh w ay l
whimsical	hh w ih m z ih k l
whining	hh w ay n ih ng
whip	hh w ih p #1
whiplashes	hh w ih p l ae sh ih z
whipped	hh w ih p t
whipsawed	hh w ih p s aa d
whirling	hh w er l ih ng
whiskey	hh w ih s k iy
whisper	hh w ih s p er #1
whispered	hh w ih s p er d
whistling	hh w ih s l ih ng
white	hh w ay t
whizzing	hh w ih z ih ng
who	hh uw #1
whoever	hh uw eh v er
whole	hh ow l #2
wholesome	hh ow l s ah m
whoppers	hh w aa p er z
whorls	hh w er l z
whosoever	hh uw s ow eh v er
why	hh w ay #1
wick	w ih k
wide	w ay d #1
widely	w ay d l iy
wider	w ay d er
widow	w ih d ow
width	w ih d th #1
widths	w ih d th s
wieners	w iy n er z
wife	w ay f
wild	w ay l d #1
wildly	w ay l d l iy
will	w ih l #2
willow	w ih l ow #1
willowy	w ih l ow iy
win	w ih n #1
window	w ih n d ow #1
windowpanes	w ih n d ow p ey n z
windows	w ih n d ow z
winds	w ih n d z
windshield	w ih n d sh iy l d
wine	w ay n
wingman	w ih ng m ah n
winking	w ih ng k ih ng
winter	w ih n t er
wipe	w ay p
wire	w ay er #1
wire-haired	w ay er hh ae r d
wired	w ay er d
wisdom	w ih z d ah m
wise	w ay z #1
wised	w ay z d
wish	w ih sh #1
wishful	w ih sh f uh l
witches	w ih ch ih z
with	w ih dh #1
withdraw	w ih dh d r aa
within	w ih dh ih n
without	w ih dh aw t
witnesses	w ih t n ih s ih z
witnessing	w ih t n ih s ih ng
wobble	w aa b l #1
wobbled	w aa b l d
woe	w ow #1
woman	w uh m ah n
women	w ih m ah n
won't	w ow n t
wondered	w ah n d er d
wonderful	w ah n d er f uh l #1
wonderfully	w ah n d er f uh l iy
wonders	w ah n d er z
wood	w uh d #1
wooded	w uh d ih d
wooden	w uh d n
woodland	w uh d l ae n d
woods	w uh d z
wool	w uh l #1
woolen	w uh l ah n
woolly	w uh l l iy
wops	w aa p s
word	w er d #1
words	w er d z
wore	w aa r #2
work	w er k #1
workable	w er k ah b l
worked	w er k t
worker	w er k er #1
workers	w er k er z
working	w er k ih ng
works	w er k s
world	w er l d #1
world's	w er l d z
worm	w er m
worn	w aa r n #2
worried	w er iy d
worries	w er iy z
worry	w er iy #1
worse	w er s
worship	w er sh ih p
worth	w er th
would	w uh d #2
would've	w uh d ah v
wounds	w uw n d z
wound~n	w uw n d #1
wound~v	w aw n d
wrap	r ae p #1
wraps	r ae p s
wrinkled	r ih ng k l d
wrist	r ih s t #1
writers	r ay t er z
writes	r ay t s #3
written	r ih t n
wrong	r aa ng
wrote	r ow t
x	eh k s #1
x-ray	eh k s r ey
y'all	y aa l
ya	y ah #1
yacht	y aa t
yard	y aa r d #1
yards	y aa r d z
yarn	y aa r n
yeah	y eh ah
year	y ih r #1
year's	y ih r z #1
yearly	y ih r l iy
years	y ih r z #2
yell	y eh l #1
yelled	y eh l d
yellow	y eh l ow
yes	y eh s #1
yesterday	y eh s t er d ey
yet	y eh t
yield	y iy l d #1
yielded	y iy l d ih d
yogurt	y ow g er t
york	y aa r k
you	y uw #1
you'd	y uw d
you'll	y uw l
you're	y uh r #1
you've	y uw v
young	y ah ng #1
youngsters	y ah ng s t er z
your	y uh r #2
yours	y uh r z
yourself	y uh r s eh l f
youth	y uw th
zeal	z iy l
zealous	z eh l ah s
zebras	z iy b r ah z
zig-	z ih g #1
zig-zagged	z ih g z ae g d
zinnias	z ih n iy ah z
zip	z ih p #1
zippers	z ih p er z
zircons	z er k aa n z
zombie	z aa m b iy
zones	z ow n z
zoning	z ow n ih ng
zoo	z uw #1
zoologist	z ow aa l ah jh ih s t
zoos	z uw z
<s>	sil #1
</s>	sil #2
SIL	sil #3
